TxnID,Date,Description,Internal reference,External reference,Currency,Amount,Balance after transaction,Match,Booking,Synced to Dooer date
"1634","2019-01-25","Avi Överdrag","Avi Överdrag","Avi Överdrag","SEK","-100","-502.78","","A10","2019-01-29 10:53:56"
"1633","2019-01-15","Avi Överdrag","Avi Överdrag","Avi Överdrag","SEK","-100","-402.78","","A11","2019-01-29 10:53:56"
"1632","2019-01-02","Trygg-Hansa","Trygg-Hansa","Trygg-Hansa","SEK","-301","-302.78","","A12","2019-01-29 10:53:56"
"1631","2019-01-02","8778877815  /18-12-29","8778877815  /18-12-29","8778877815  /18-12-29","SEK","-1866.27","-1.78","","A13","2019-01-29 10:53:56"
"1630","2019-01-02","4158004537  /18-12-28","4158004537  /18-12-28","4158004537  /18-12-28","SEK","-535.86","1864.49","","A14","2019-01-29 10:53:56"
"1629","2019-01-02","8444658243  /18-12-30","8444658243  /18-12-30","8444658243  /18-12-30","SEK","-54.97","2400.35","","A15","2019-01-29 10:53:56"
"1628","2019-01-02","4154486673  /18-12-30","4154486673  /18-12-30","4154486673  /18-12-30","SEK","-230.98","2455.32","Doc 1119","A17","2019-01-29 10:53:56"
"1627","2019-01-02","3122815333  /18-12-28","3122815333  /18-12-28","3122815333  /18-12-28","SEK","-914.65","2686.3","","A16","2019-01-29 10:53:56"
"1626","2018-12-27","Bg 759-8147","Bg 759-8147","Bg 759-8147","SEK","3500","3600.95","","","2019-01-29 10:53:56"
"1625","2018-12-27","San Francisc/18-12-21","San Francisc/18-12-21","San Francisc/18-12-21","SEK","-92.83","100.95","","A1018","2019-01-29 10:53:56"
"1624","2018-12-14","8773818743  /18-12-11","8773818743  /18-12-11","8773818743  /18-12-11","SEK","-233.01","193.78","","A1017","2019-01-29 10:53:56"
"1623","2018-12-12","London      /18-12-11","London      /18-12-11","London      /18-12-11","SEK","-233.15","426.79","","A1019","2019-01-29 10:53:56"
"1622","2018-12-12","8662781349  /18-12-11","8662781349  /18-12-11","8662781349  /18-12-11","SEK","-318.95","659.94","","A1020","2019-01-29 10:53:56"
"1621","2018-12-12","Tallinn     /18-12-12","Tallinn     /18-12-12","Tallinn     /18-12-12","SEK","-612.63","978.89","","A1021","2019-01-29 10:53:56"
"1620","2018-12-10","Dublin      /18-12-09","Dublin      /18-12-09","Dublin      /18-12-09","SEK","-105.01","1591.52","","A1022","2019-01-29 10:53:56"
"1619","2018-12-07","8887799666  /18-12-06","8887799666  /18-12-06","8887799666  /18-12-06","SEK","-974","1696.53","","A1023","2019-01-29 10:53:56"
"1618","2018-12-06","Astrid. T2z5","Astrid. T2z5","Astrid. T2z5","SEK","2671.77","2670.53","Doc 1139","A1016","2019-01-29 10:53:56"
"1617","2018-12-04","4154486673  /18-12-03","4154486673  /18-12-03","4154486673  /18-12-03","SEK","-65.17","-1.24","","A1024","2019-01-29 10:53:56"
"1572","2018-12-04","Utmätning","Utmätning","Utmätning","SEK","-4930","63.93","","A1025","2018-12-04 15:55:13"
"1571","2018-12-03","Toronto     /18-12-02","Toronto     /18-12-02","Toronto     /18-12-02","SEK","-23.27","4993.93","Doc 1085","A1015","2018-12-04 15:55:13"
"1570","2018-12-03","Google  Clou/18-12-02","Google  Clou/18-12-02","Google  Clou/18-12-02","SEK","-0.02","5017.2","","A1026","2018-12-04 15:55:13"
"1569","2018-12-03","San Francisc/18-12-01","San Francisc/18-12-01","San Francisc/18-12-01","SEK","-93.8","5017.22","Doc 1086","A1014","2018-12-04 15:55:13"
"1568","2018-12-03","6463978051  /18-11-30","6463978051  /18-11-30","6463978051  /18-11-30","SEK","-94.92","5111.02","","A1027","2018-12-04 15:55:13"
"1567","2018-12-03","Ccögoogle Co/18-12-01","Ccögoogle Co/18-12-01","Ccögoogle Co/18-12-01","SEK","-334.01","5205.94","","A1028","2018-12-04 15:55:13"
"1566","2018-12-03","Trygg-Hansa","Trygg-Hansa","Trygg-Hansa","SEK","-301","5539.95","","A1029","2018-12-04 15:55:13"
"1565","2018-12-03","8444658243  /18-11-30","8444658243  /18-11-30","8444658243  /18-11-30","SEK","-55.59","5840.95","","A1030","2018-12-04 15:55:13"
"1564","2018-11-29","3122815333  /18-11-28","3122815333  /18-11-28","3122815333  /18-11-28","SEK","-925.49","5896.54","","A986","2018-12-04 15:55:13"
"1563","2018-11-28","8778877815  /18-11-26","8778877815  /18-11-26","8778877815  /18-11-26","SEK","-1370.18","6822.03","Doc 1090","A985","2018-12-04 15:55:13"
"1562","2018-11-26","San Francisc/18-11-24","San Francisc/18-11-24","San Francisc/18-11-24","SEK","-93.47","8192.21","","A987","2018-12-04 15:55:13"
"1561","2018-11-26","4158004537  /18-11-24","4158004537  /18-11-24","4158004537  /18-11-24","SEK","-540.54","8285.68","Doc 1080","A991","2018-12-04 15:55:13"
"1560","2018-11-26","Kostnad","Kostnad","Kostnad","SEK","-35","8826.22","","A984","2018-12-04 15:55:13"
"1559","2018-11-26","283309538724","283309538724","283309538724","SEK","-16590.88","8861.22","","A988","2018-12-04 15:55:13"
"1558","2018-11-26","4154486673  /18-11-23","4154486673  /18-11-23","4154486673  /18-11-23","SEK","-232.99","25452.1","Doc 1078","A990","2018-12-04 15:55:13"
"1557","2018-11-26","Norrsken Hou/18-11-23","Norrsken Hou/18-11-23","Norrsken Hou/18-11-23","SEK","-9312.5","25685.09","Doc 1077,Doc 1079","A971","2018-12-04 15:55:13"
"1556","2018-11-23","Bg 759-8147","Bg 759-8147","Bg 759-8147","SEK","31250","34997.59","","","2018-12-04 15:55:13"
"1555","2018-11-21","8778877815  /18-11-20","8778877815  /18-11-20","8778877815  /18-11-20","SEK","-456.05","3747.59","","A970","2018-12-04 15:55:13"
"1554","2018-11-19","8778877815  /18-11-17","8778877815  /18-11-17","8778877815  /18-11-17","SEK","-920.37","4203.64","","A958","2018-12-04 15:55:13"
"1553","2018-11-19","15126403000 /18-11-18","15126403000 /18-11-18","15126403000 /18-11-18","SEK","-269.61","5124.01","","A975","2018-12-04 15:55:13"
"1552","2018-11-19","Klientmedel Billogram AB","",,"SEK","-1256","5393.62","Doc 1011","A977","2018-12-04 15:55:13"
"1551","2018-11-16","The Italian /18-11-15","The Italian /18-11-15","The Italian /18-11-15","SEK","-162","6649.62","Doc 1074","A957","2018-12-04 15:55:13"
"1550","2018-11-16","D1006-P219","D1006-P219","147","SEK","-1590","6811.62","Doc 1006","A979","2018-12-04 15:55:13"
"1549","2018-11-16","D997-P228","D997-P228","Utlägg, Resa","SEK","-119","8401.62","Doc 997","A976","2018-12-04 15:55:13"
"1548","2018-11-16","D382-P230","D382-P230","Utlägg Frisk","SEK","-550","8520.62","Doc 382","A960","2018-12-04 15:55:13"
"1547","2018-11-16","D989-P229","D989-P229","Interreprese","SEK","-647","9070.62","Doc 989","A961","2018-12-04 15:55:13"
"1546","2018-11-13","8662781349  /18-11-12","8662781349  /18-11-12","8662781349  /18-11-12","SEK","-320.32","9717.62","","A953","2018-12-04 15:55:13"
"1545","2018-11-13","Kostnad","Kostnad","Kostnad","SEK","-35","10037.94","","A968","2018-12-04 15:55:13"
"1544","2018-11-13","283179460558","283179460558","283179460558","SEK","-26754.25","10072.94","","A982","2018-12-04 15:55:13"
"1543","2018-11-13","Bg 759-8147","Bg 759-8147","Bg 759-8147","SEK","31250","36827.19","","","2018-12-04 15:55:13"
"1542","2018-11-12","London      /18-11-11","London      /18-11-11","London      /18-11-11","SEK","-232.48","5577.19","Doc 1071","A964","2018-12-04 15:55:13"
"1541","2018-11-12","8773818743  /18-11-11","8773818743  /18-11-11","8773818743  /18-11-11","SEK","-232.48","5809.67","","A956","2018-12-04 15:55:13"
"1540","2018-11-12","Tallinn     /18-11-12","Tallinn     /18-11-12","Tallinn     /18-11-12","SEK","-609.77","6042.15","Doc 1072","A983","2018-12-04 15:55:13"
"1539","2018-11-12","G Co/helppay/18-11-09","G Co/helppay/18-11-09","G Co/helppay/18-11-09","SEK","-232.48","6651.92","Doc 1070","A981","2018-12-04 15:55:13"
"1538","2018-11-07","8887799666  /18-11-06","8887799666  /18-11-06","8887799666  /18-11-06","SEK","-983.29","6884.4","","A962","2018-12-04 15:55:13"
"1537","2018-11-06","Db Tt/cchelp/18-11-05","Db Tt/cchelp/18-11-05","Db Tt/cchelp/18-11-05","SEK","-105.53","7867.69","Doc 1097","A973","2018-12-04 15:55:13"
"1536","2018-11-06","562-292-3834/18-11-04","562-292-3834/18-11-04","562-292-3834/18-11-04","SEK","-270.41","7973.22","","A980","2018-12-04 15:55:13"
"1535","2018-11-06","8009799850  /18-11-05","8009799850  /18-11-05","8009799850  /18-11-05","SEK","-559.47","8243.63","Doc 1065","A966","2018-12-04 15:55:13"
"1529","2018-11-05","Google  Clou/18-11-02","Google  Clou/18-11-02","Google  Clou/18-11-02","SEK","-0.01","8803.1","Doc 1061","A803","2018-11-05 13:14:33"
"1528","2018-11-05","4154486673  /18-11-02","4154486673  /18-11-02","4154486673  /18-11-02","SEK","-65.17","8803.11","Doc 1068","A989","2018-11-05 13:14:33"
"1527","2018-11-05","Toronto     /18-11-02","Toronto     /18-11-02","Toronto     /18-11-02","SEK","-116.1","8868.28","Doc 1057","A969","2018-11-05 13:14:33"
"1526","2018-11-02","Ccögoogle Co/18-11-01","Ccögoogle Co/18-11-01","Ccögoogle Co/18-11-01","SEK","-339.12","8984.38","Doc 1026","A949","2018-11-05 13:14:33"
"1525","2018-11-02","6463978051  /18-11-01","6463978051  /18-11-01","6463978051  /18-11-01","SEK","-52.92","9323.5","Doc 1067","A954","2018-11-05 13:14:33"
"1524","2018-11-01","San Francisc/18-10-31","San Francisc/18-10-31","San Francisc/18-10-31","SEK","-161.82","9376.42","","A952","2018-11-05 13:14:33"
"1523","2018-11-01","Trygg-Hansa","Trygg-Hansa","Trygg-Hansa","SEK","-301","9538.24","","A978","2018-11-05 13:14:33"
"1522","2018-10-31","8444658243  /18-10-30","8444658243  /18-10-30","8444658243  /18-10-30","SEK","-56.01","9839.24","","A904","2018-11-05 13:14:33"
"1397","2018-10-30","Skatteverket","",,"SEK","-47502","9895.25","","A916","2018-10-30 08:55:39"
"1396","2018-10-29","3122815333  /18-10-28","3122815333  /18-10-28","3122815333  /18-10-28","SEK","-931.13","57397.25","Doc 1060","A840","2018-10-30 08:55:39"
"1395","2018-10-29","Everyday AB","Everyday AB","Everyday AB","SEK","6250","58328.38","","A839","2018-10-30 08:55:39"
"1394","2018-10-29","52223425127","52223425127","Everyday AB","SEK","-6250","52078.38","","A838","2018-10-30 08:55:39"
"1391","2018-10-29","Klientmedel Billogram AB","",,"SEK","-1139","58328.38","Doc 1012","A837","2018-10-29 09:07:28"
"1390","2018-10-29","8778877815  /18-10-26","8778877815  /18-10-26","8778877815  /18-10-26","SEK","-3063.03","59467.38","Doc 1051","A836","2018-10-29 09:07:28"
"1389","2018-10-26","4158004537  /18-10-24","4158004537  /18-10-24","4158004537  /18-10-24","SEK","-543.58","62530.41","Doc 1017","A835","2018-10-29 09:07:28"
"1388","2018-10-26","R123-P221","R123-P221","Lön","SEK","-16333","63073.99","Rep 123","A833","2018-10-29 09:07:28"
"1387","2018-10-26","Bg 759-8147","Bg 759-8147","Bg 759-8147","SEK","74812.5","79406.99","","","2018-10-29 09:07:28"
"1386","2018-10-25","Norrsken Hou/18-10-24","Norrsken Hou/18-10-24","Norrsken Hou/18-10-24","SEK","-11250","4594.49","Doc 1013","A806","2018-10-29 09:07:28"
"1385","2018-10-25","8887799666  /18-10-24","8887799666  /18-10-24","8887799666  /18-10-24","SEK","-164.73","15844.49","Doc 1019","A832","2018-10-29 09:07:28"
"1384","2018-10-24","4154486673  /18-10-23","4154486673  /18-10-23","4154486673  /18-10-23","SEK","-232.22","16009.22","Doc 1016","A831","2018-10-29 09:07:28"
"1383","2018-10-22","8778877815  /18-10-20","8778877815  /18-10-20","8778877815  /18-10-20","SEK","-454.73","16241.44","","A905","2018-10-29 09:07:28"
"1382","2018-10-22","Lowell Sverige AB ""fd Li","",,"SEK","-180.22","16696.17","Doc 1003","A830","2018-10-29 09:07:28"
"1381","2018-10-19","15126403000 /18-10-18","15126403000 /18-10-18","15126403000 /18-10-18","SEK","-268.15","16876.39","","A906","2018-10-29 09:07:28"
"1380","2018-10-18","8778877815  /18-10-17","8778877815  /18-10-17","8778877815  /18-10-17","SEK","-908.45","17144.54","Doc 1030","A848,A880","2018-10-29 09:07:28"
"1379","2018-10-15","Bruce       /18-10-14","Bruce       /18-10-14","Bruce       /18-10-14","SEK","-799","18052.99","Doc 1093","A907","2018-10-29 09:07:28"
"1378","2018-10-15","Tallinn     /18-10-12","Tallinn     /18-10-12","Tallinn     /18-10-12","SEK","-616.79","18851.99","Doc 1054","A829","2018-10-29 09:07:28"
"1377","2018-10-12","London      /18-10-11","London      /18-10-11","London      /18-10-11","SEK","-233.75","19468.78","Doc 1015","A908","2018-10-29 09:07:28"
"1376","2018-10-12","8773818743  /18-10-11","8773818743  /18-10-11","8773818743  /18-10-11","SEK","-233.75","19702.53","Doc 1048","A828","2018-10-29 09:07:28"
"1375","2018-10-11","Klientmedel Billogram AB","",,"SEK","-1781","19936.28","Doc 979","A827","2018-10-29 09:07:28"
"1374","2018-10-10","61383766284 /18-10-09","61383766284 /18-10-09","61383766284 /18-10-09","SEK","-253.09","21717.28","","A909","2018-10-29 09:07:28"
"1373","2018-10-09","8662781349  /18-10-08","8662781349  /18-10-08","8662781349  /18-10-08","SEK","-320.65","21970.37","","A910","2018-10-29 09:07:28"
"1372","2018-10-08","8887799666  /18-10-06","8887799666  /18-10-06","8887799666  /18-10-06","SEK","-543.89","22291.02","Doc 1018","A788","2018-10-29 09:07:28"
"1371","2018-10-08","562-292-3834/18-10-05","562-292-3834/18-10-05","562-292-3834/18-10-05","SEK","-270.46","22834.91","Doc 1034","A826","2018-10-29 09:07:28"
"1370","2018-10-08","Db Tt/cchelp/18-10-05","Db Tt/cchelp/18-10-05","Db Tt/cchelp/18-10-05","SEK","-106.75","23105.37","Doc 1056","A825","2018-10-29 09:07:28"
"1369","2018-10-08","8009799850  /18-10-05","8009799850  /18-10-05","8009799850  /18-10-05","SEK","-559.57","23212.12","Doc 1020","A824","2018-10-29 09:07:28"
"1368","2018-10-04","Barcelona   /18-10-03","Barcelona   /18-10-03","Barcelona   /18-10-03","SEK","-319.36","23771.69","Doc 1092","A911","2018-10-29 09:07:28"
"1367","2018-10-03","Toronto     /18-10-02","Toronto     /18-10-02","Toronto     /18-10-02","SEK","-135.83","24091.05","Doc 1001","A912","2018-10-29 09:07:28"
"1366","2018-10-03","4154486673  /18-10-02","4154486673  /18-10-02","4154486673  /18-10-02","SEK","-64.77","24226.88","Doc 1009","A823","2018-10-29 09:07:28"
"1363","2018-10-02","Cc Google Co/18-10-01","Cc Google Co/18-10-01","Cc Google Co/18-10-01","SEK","-296.43","24291.65","Doc 1000","A731","2018-10-03 08:42:52"
"1362","2018-10-02","6463978051  /18-10-01","6463978051  /18-10-01","6463978051  /18-10-01","SEK","-51.03","24588.08","","A913","2018-10-03 08:42:52"
"1361","2018-10-02","8009799850  /18-10-01","8009799850  /18-10-01","8009799850  /18-10-01","SEK","-18.73","24639.11","","A914","2018-10-03 08:42:52"
"1360","2018-10-02","Klientmedel Billogram AB","",,"SEK","-1074","24657.84","Doc 987","A822","2018-10-03 08:42:52"
"1359","2018-10-01","8444658243  /18-09-30","8444658243  /18-09-30","8444658243  /18-09-30","SEK","-54.36","25731.84","Doc 1042","A775","2018-10-03 08:42:52"
"1358","2018-10-01","Trygg-Hansa","Trygg-Hansa","Trygg-Hansa","SEK","-301","25786.2","","A915","2018-10-03 08:42:52"
"1357","2018-10-01","3122815333  /18-09-28","3122815333  /18-09-28","3122815333  /18-09-28","SEK","-904.4","26087.2","Doc 1062","A820","2018-10-03 08:42:52"
"1356","2018-09-27","8778877815  /18-09-26","8778877815  /18-09-26","8778877815  /18-09-26","SEK","-1504.21","26991.6","Doc 1005","A709","2018-10-03 08:42:52"
"1355","2018-09-26","4158004537  /18-09-24","4158004537  /18-09-24","4158004537  /18-09-24","SEK","-523.52","28495.81","Doc 994","A704","2018-10-03 08:42:52"
"1354","2018-09-25","Taxi Stockho/18-09-23","Taxi Stockho/18-09-23","Taxi Stockho/18-09-23","SEK","-620","29019.33","Doc 996","A706","2018-10-03 08:42:52"
"1353","2018-09-25","Norrsken Hou/18-09-24","Norrsken Hou/18-09-24","Norrsken Hou/18-09-24","SEK","-11250","29639.33","Doc 990","A702","2018-10-03 08:42:52"
"1352","2018-09-25","Kostnad","Kostnad","Kostnad","SEK","-35","40889.33","","A714","2018-10-03 08:42:52"
"1351","2018-09-25","282689137284","282689137284","282689137284","SEK","-41922.53","40924.33","Doc 961","A795","2018-10-03 08:42:52"
"1350","2018-09-25","R118-P214","R118-P214","Lön","SEK","-16333","82846.86","Rep 118","A743","2018-10-03 08:42:52"
"1349","2018-09-25","R118-P213","R118-P213","Lön","SEK","-26170","99179.86","Rep 118","A744","2018-10-03 08:42:52"
"1348","2018-09-25","R118-P215","R118-P215","Lön","SEK","-26170","125349.86","Rep 118","A745","2018-10-03 08:42:52"
"1347","2018-09-25","Cool Company Skandinavie","",,"SEK","-19125","151519.86","Doc 940","A739","2018-10-03 08:42:52"
"1346","2018-09-24","4154486673  /18-09-23","4154486673  /18-09-23","4154486673  /18-09-23","SEK","-225.52","170644.86","Doc 993","A732","2018-10-03 08:42:52"
"1345","2018-09-21","8778877815  /18-09-20","8778877815  /18-09-20","8778877815  /18-09-20","SEK","-446.17","170870.38","","A887","2018-10-03 08:42:52"
"1344","2018-09-18","8778877815  /18-09-17","8778877815  /18-09-17","8778877815  /18-09-17","SEK","-918.12","171316.55","","A847,A881","2018-09-19 13:48:51"
"1343","2018-09-18","Bg 759-8147","Bg 759-8147","Bg 759-8147","SEK","82063","172234.67","","","2018-09-19 13:48:51"
"1342","2018-09-17","Bruce       /18-09-16","Bruce       /18-09-16","Bruce       /18-09-16","SEK","-790","90171.67","Doc 1094","A888","2018-09-19 13:48:51"
"1341","2018-09-14","8662781349  /18-09-13","8662781349  /18-09-13","8662781349  /18-09-13","SEK","-316.56","90961.67","Doc 973","A733","2018-09-19 13:48:51"
"1340","2018-09-13","35314369001 /18-09-12","35314369001 /18-09-12","35314369001 /18-09-12","SEK","-13532.79","91278.23","Doc 986","A730","2018-09-19 13:48:51"
"1339","2018-09-13","Tallinn     /18-09-12","Tallinn     /18-09-12","Tallinn     /18-09-12","SEK","-622.24","104811.02","Doc 984","A700","2018-09-19 13:48:51"
"1338","2018-09-13","Klientmedel Billogram AB","",,"SEK","-1354","105433.26","Doc 963","A746","2018-09-19 13:48:51"
"1337","2018-09-13","Klientmedel Billogram AB","",,"SEK","-1244","106787.26","Doc 926","A742","2018-09-19 13:48:51"
"1336","2018-09-13","Klientmedel Billogram AB","",,"SEK","-148","108031.26","Doc 962","A747","2018-09-19 13:48:51"
"1335","2018-09-12","London      /18-09-11","London      /18-09-11","London      /18-09-11","SEK","-232.62","108179.26","","A759,A919","2018-09-19 13:48:51"
"1334","2018-09-12","8773818743  /18-09-11","8773818743  /18-09-11","8773818743  /18-09-11","SEK","-232.62","108411.88","Doc 983","A736","2018-09-19 13:48:51"
"1333","2018-09-11","8887799666  /18-09-10","8887799666  /18-09-10","8887799666  /18-09-10","SEK","-129.9","108644.5","Doc 981","A748","2018-09-19 13:48:51"
"1332","2018-09-10","8887799666  /18-09-09","8887799666  /18-09-09","8887799666  /18-09-09","SEK","-136.31","108774.4","Doc 980","A698","2018-09-19 13:48:51"
"1331","2018-09-07","562-292-3834/18-09-05","562-292-3834/18-09-05","562-292-3834/18-09-05","SEK","-271.11","108910.71","Doc 1036","A780","2018-09-19 13:48:51"
"1330","2018-09-07","8009799850  /18-09-06","8009799850  /18-09-06","8009799850  /18-09-06","SEK","-137.05","109181.82","Doc 976","A694","2018-09-19 13:48:51"
"1329","2018-09-07","8009799850  /18-09-06","8009799850  /18-09-06","8009799850  /18-09-06","SEK","-135.93","109318.87","Doc 978","A696","2018-09-19 13:48:51"
"1328","2018-09-07","8887799666  /18-09-06","8887799666  /18-09-06","8887799666  /18-09-06","SEK","-151.61","109454.8","Doc 977","A750","2018-09-19 13:48:51"
"1327","2018-09-06","Db Tt/cchelp/18-09-05","Db Tt/cchelp/18-09-05","Db Tt/cchelp/18-09-05","SEK","-107.66","109606.41","Doc 1055","A766","2018-09-19 13:48:51"
"1326","2018-09-06","8009799850  /18-09-05","8009799850  /18-09-05","8009799850  /18-09-05","SEK","-93.61","109714.07","Doc 970","A691","2018-09-19 13:48:51"
"1325","2018-09-06","8009799850  /18-09-05","8009799850  /18-09-05","8009799850  /18-09-05","SEK","-46.72","109807.68","Doc 971","A711","2018-09-19 13:48:51"
"1324","2018-09-04","Barcelona   /18-09-03","Barcelona   /18-09-03","Barcelona   /18-09-03","SEK","-325.83","109854.4","Doc 1091","A889","2018-09-19 13:48:51"
"1323","2018-09-04","Cc Google Co/18-09-03","Cc Google Co/18-09-03","Cc Google Co/18-09-03","SEK","-304.11","110180.23","Doc 943","A737","2018-09-19 13:48:51"
"1322","2018-09-03","Toronto     /18-09-02","Toronto     /18-09-02","Toronto     /18-09-02","SEK","-93.72","110484.34","Doc 954","A687","2018-09-19 13:48:51"
"1321","2018-09-03","6463978051  /18-09-01","6463978051  /18-09-01","6463978051  /18-09-01","SEK","-52.49","110578.06","","A890","2018-09-19 13:48:51"
"1320","2018-09-03","4154486673  /18-09-02","4154486673  /18-09-02","4154486673  /18-09-02","SEK","-65.73","110630.55","Doc 969","A689","2018-09-19 13:48:51"
"1319","2018-09-03","Stockholms B/18-09-01","Stockholms B/18-09-01","Stockholms B/18-09-01","SEK","-45","110696.28","Doc 945","A734","2018-09-19 13:48:51"
"1318","2018-09-03","Stockholms B/18-09-01","Stockholms B/18-09-01","Stockholms B/18-09-01","SEK","-1875","110741.28","Doc 944","A735","2018-09-19 13:48:51"
"1317","2018-09-03","Trygg-Hansa","Trygg-Hansa","Trygg-Hansa","SEK","-301","112616.28","","A891","2018-09-19 13:48:51"
"1316","2018-09-03","Hi3g","Hi3g","Hi3g","SEK","-12","112917.28","","A892","2018-09-19 13:48:51"
"1315","2018-09-03","Buco Nero   /18-08-31","Buco Nero   /18-08-31","Buco Nero   /18-08-31","SEK","-900","112929.28","","A893","2018-09-19 13:48:51"
"1314","2018-08-31","8444658243  /18-08-30","8444658243  /18-08-30","8444658243  /18-08-30","SEK","-55.83","113829.28","Doc 1045","A846","2018-09-19 13:48:51"
"1313","2018-08-29","3122815333  /18-08-28","3122815333  /18-08-28","3122815333  /18-08-28","SEK","-928.87","113885.11","Doc 942","A738","2018-09-19 13:48:51"
"1312","2018-08-27","4158004537  /18-08-24","4158004537  /18-08-24","4158004537  /18-08-24","SEK","-543.97","114813.98","Doc 936","A740","2018-09-19 13:48:51"
"1311","2018-08-27","4158004537  /18-08-24","4158004537  /18-08-24","4158004537  /18-08-24","SEK","-0.38","115357.95","Doc 1028","A786","2018-09-19 13:48:51"
"1310","2018-08-27","Reggev Hummu/18-08-24","Reggev Hummu/18-08-24","Reggev Hummu/18-08-24","SEK","-360","115358.33","Doc 939","A678","2018-09-19 13:48:51"
"1309","2018-08-27","Norrsken Hou/18-08-24","Norrsken Hou/18-08-24","Norrsken Hou/18-08-24","SEK","-15000","115718.33","Doc 934","A674","2018-09-19 13:48:51"
"1308","2018-08-24","4154486673  /18-08-23","4154486673  /18-08-23","4154486673  /18-08-23","SEK","-233.77","130718.33","Doc 935","A845","2018-09-19 13:48:51"
"1307","2018-08-23","Bg 759-8147","Bg 759-8147","Bg 759-8147","SEK","3180","130952.1","","","2018-09-19 13:48:51"
"1306","2018-08-22","Everyday AB","Everyday AB","Everyday AB","SEK","34000","127772.1","","","2018-09-19 13:48:51"
"1305","2018-08-21","8778877815  /18-08-20","8778877815  /18-08-20","8778877815  /18-08-20","SEK","-461.99","93772.1","Doc 959","A842","2018-09-19 13:48:51"
"1304","2018-08-20","Kostnad","Kostnad","Kostnad","SEK","-35","94234.09","","A713,A715,A917","2018-09-19 13:48:51"
"1303","2018-08-20","282328901779","282328901779","282328901779","SEK","-26125.63","94269.09","Doc 924","A841","2018-09-19 13:48:51"
"1302","2018-08-20","Skatteverket","Skatt",,"SEK","-2181","120394.72","","A902","2018-09-19 13:48:51"
"1301","2018-08-20","8778877815  /18-08-17","8778877815  /18-08-17","8778877815  /18-08-17","SEK","-936","122575.72","Doc 965","A741","2018-09-19 13:48:51"
"1295","2018-08-17","Alexander Awareness Tg","Faktura 1009962","Faktura 1009962","SEK","-850","123511.72","Doc 1096","A882","2018-08-19 16:19:11"
"1294","2018-08-15","3233752822  /18-08-13","3233752822  /18-08-13","3233752822  /18-08-13","SEK","-1289.59","124361.72","Doc 929","A640","2018-08-19 16:19:11"
"1293","2018-08-13","8773818743  /18-08-11","8773818743  /18-08-11","8773818743  /18-08-11","SEK","-234.18","125651.31","","A633,A921","2018-08-19 16:19:11"
"1292","2018-08-13","London      /18-08-11","London      /18-08-11","London      /18-08-11","SEK","-234.18","125885.49","Doc 927","A663","2018-08-19 16:19:11"
"1291","2018-08-13","Tallinn     /18-08-12","Tallinn     /18-08-12","Tallinn     /18-08-12","SEK","-619.83","126119.67","Doc 930","A639","2018-08-19 16:19:11"
"1290","2018-08-13","12122557327 /18-08-12","12122557327 /18-08-12","12122557327 /18-08-12","SEK","-327.86","126739.5","Doc 972","A667","2018-08-19 16:19:11"
"1289","2018-08-10","8662781349  /18-08-09","8662781349  /18-08-09","8662781349  /18-08-09","SEK","-316.25","127067.36","Doc 923","A645","2018-08-19 16:19:11"
"1288","2018-08-10","Skatteverket","",,"SEK","-55248","127383.61","","A901","2018-08-19 16:19:11"
"1287","2018-08-09","Bruce       /18-08-08","Bruce       /18-08-08","Bruce       /18-08-08","SEK","-711","182631.61","Doc 1095","A883","2018-08-19 16:19:11"
"1286","2018-08-09","3233752822  /18-08-07","3233752822  /18-08-07","3233752822  /18-08-07","SEK","-230.48","183342.61","Doc 920","A643","2018-08-19 16:19:10"
"1285","2018-08-09","Klientmedel Billogram AB","",,"SEK","-1244","183573.09","Doc 905","A627","2018-08-19 16:19:10"
"1284","2018-08-08","562-292-3834/18-08-06","562-292-3834/18-08-06","562-292-3834/18-08-06","SEK","-265.89","184817.09","Doc 1033","A630","2018-08-19 16:19:10"
"1283","2018-08-07","Skatteverket","Skatt",,"SEK","-2204","185082.98","","A900","2018-08-19 16:19:10"
"1282","2018-08-06","Db Tt/cchelp/18-08-05","Db Tt/cchelp/18-08-05","Db Tt/cchelp/18-08-05","SEK","-105.57","187286.98","Doc 966","A655","2018-08-19 16:19:10"
"1281","2018-08-06","Est Moms","Est Moms","Est Moms","SEK","-34000","187392.55","","A628","2018-08-19 16:19:10"
"1280","2018-08-06","Hi3g","Hi3g","Hi3g","SEK","-542","221392.55","","A884","2018-08-19 16:19:10"
"1279","2018-08-03","Toronto     /18-08-02","Toronto     /18-08-02","Toronto     /18-08-02","SEK","-90.79","221934.55","Doc 917","A664","2018-08-19 16:19:10"
"1278","2018-08-03","4154486673  /18-08-02","4154486673  /18-08-02","4154486673  /18-08-02","SEK","-63.68","222025.34","Doc 925","A644","2018-08-19 16:19:10"
"1277","2018-08-03","Klientmedel Billogram AB","",,"SEK","-387","222089.02","Doc 914","A629","2018-08-19 16:19:10"
"1276","2018-08-02","Ccögoogle Co/18-08-01","Ccögoogle Co/18-08-01","Ccögoogle Co/18-08-01","SEK","-294.78","222476.02","Doc 915","A665","2018-08-19 16:19:10"
"1275","2018-08-02","6463978051  /18-08-01","6463978051  /18-08-01","6463978051  /18-08-01","SEK","-50.28","222770.8","","A885","2018-08-19 16:19:10"
"1274","2018-08-02","Kostnad","Kostnad","Kostnad","SEK","-385","222821.08","","A712","2018-08-19 16:19:10"
"1273","2018-08-02","282148806198","282148806198","282148806198","SEK","-43689.29","223206.08","Doc 916","A647","2018-08-19 16:19:10"
"1272","2018-08-01","Trygg-Hansa","Trygg-Hansa","Trygg-Hansa","SEK","-301","266895.37","","A886","2018-08-19 16:19:10"
"1271","2018-07-31","8444658243  /18-07-30","8444658243  /18-07-30","8444658243  /18-07-30","SEK","-53.96","267196.37","Doc 1041","A777","2018-08-19 16:19:10"
"1269","2018-07-30","3122815333  /18-07-28","3122815333  /18-07-28","3122815333  /18-07-28","SEK","-899.77","267250.33","","A894","2018-07-31 09:55:54"
"1268","2018-07-26","4158004537  /18-07-24","4158004537  /18-07-24","4158004537  /18-07-24","SEK","-262.48","268150.1","Doc 912","A475","2018-07-31 09:55:54"
"1267","2018-07-25","Norrsken Hou/18-07-24","Norrsken Hou/18-07-24","Norrsken Hou/18-07-24","SEK","-11250","268412.58","Doc 910","A473","2018-07-31 09:55:53"
"1266","2018-07-25","R102-P199","R102-P199","Lön","SEK","-30182","279662.58","Rep 102","A463","2018-07-31 09:55:53"
"1265","2018-07-25","R102-P197","R102-P197","Lön","SEK","-30182","309844.58","Rep 102","A462","2018-07-31 09:55:53"
"1264","2018-07-25","R102-P198","R102-P198","Lön","SEK","-16333","340026.58","Rep 102","A461","2018-07-31 09:55:53"
"1263","2018-07-24","4154486673  /18-07-23","4154486673  /18-07-23","4154486673  /18-07-23","SEK","-227.03","356359.58","Doc 911","A477","2018-07-31 09:55:53"
"1262","2018-07-23","Bg 759-8147","Bg 759-8147","Bg 759-8147","SEK","224063","356586.61","","","2018-07-31 09:55:53"
"1261","2018-07-23","8778877815  /18-07-20","8778877815  /18-07-20","8778877815  /18-07-20","SEK","-65.79","132523.61","","A637,A920","2018-07-31 09:55:53"
"1260","2018-07-18","8778877815  /18-07-17","8778877815  /18-07-17","8778877815  /18-07-17","SEK","-896.1","132589.4","Doc 964","A653","2018-07-31 09:55:53"
"1259","2018-07-17","Coinbase Uk,","Coinbase Uk,","Coinbase Uk, / Reversal Cbaeurjtwsckvj-15125464","SEK","10.26","133485.5","","A895","2018-07-31 09:55:53"
"1258","2018-07-16","8778877815  /18-07-11","8778877815  /18-07-11","8778877815  /18-07-11","SEK","-229.05","133475.24","Doc 907","A480","2018-07-31 09:55:53"
"1257","2018-07-16","12122557327 /18-07-13","12122557327 /18-07-13","12122557327 /18-07-13","SEK","-320.67","133704.29","Doc 974","A790","2018-07-31 09:55:53"
"1256","2018-07-13","Tallinn     /18-07-12","Tallinn     /18-07-12","Tallinn     /18-07-12","SEK","-614.39","134024.96","Doc 908","A478","2018-07-31 09:55:53"
"1255","2018-07-13","Bg 759-8147","Bg 759-8147","Bg 759-8147","SEK","59375","134639.35","","","2018-07-31 09:55:53"
"1254","2018-07-12","8662781349  /18-07-11","8662781349  /18-07-11","8662781349  /18-07-11","SEK","-309.48","75264.35","","A896","2018-07-31 09:55:53"
"1253","2018-07-12","8773818743  /18-07-11","8773818743  /18-07-11","8773818743  /18-07-11","SEK","-225.24","75573.83","Doc 1050","A770","2018-07-31 09:55:53"
"1252","2018-07-12","Everyday AB","Everyday AB","Everyday AB","SEK","56000","75799.07","","A457","2018-07-31 09:55:53"
"1251","2018-07-12","Skatteverket","",,"SEK","-92274","19799.07","","A899","2018-07-31 09:55:53"
"1250","2018-07-11","Banktjänster","Banktjänster","Banktjänster","SEK","-203","112073.07","Doc 951","A659","2018-07-31 09:55:53"
"1249","2018-07-10","Klientmedel Billogram AB","",,"SEK","-1244","112276.07","Doc 855","A464","2018-07-31 09:55:53"
"1248","2018-07-09","La Mirada   /18-07-05","La Mirada   /18-07-05","La Mirada   /18-07-05","SEK","-261.3","113520.07","Doc 1032","A784","2018-07-31 09:55:53"
"1247","2018-07-06","Dublin      /18-07-05","Dublin      /18-07-05","Dublin      /18-07-05","SEK","-104.69","113781.37","Doc 967","A654","2018-07-31 09:55:52"
"1246","2018-07-06","Cb Payments,","Cbaeurjtwsckvj","Cbaeurjtwsckvj","SEK","-10.31","113886.06","Doc 1053","A768","2018-07-31 09:55:52"
"1245","2018-07-06","Hi3g","Hi3g","Hi3g","SEK","-661","113896.37","","A897","2018-07-31 09:55:52"
"1244","2018-07-06","Klientmedel Billogram AB","",,"SEK","-59","114557.37","Doc 875","A458","2018-07-31 09:55:52"
"1243","2018-07-04","8778894546  /18-07-03","8778894546  /18-07-03","8778894546  /18-07-03","SEK","-183.78","114616.37","Doc 894","A490","2018-07-31 09:55:52"
"1242","2018-07-03","Toronto     /18-07-02","Toronto     /18-07-02","Toronto     /18-07-02","SEK","-92.35","114800.15","Doc 896","A488","2018-07-31 09:55:52"
"1241","2018-07-03","4154486673  /18-07-02","4154486673  /18-07-02","4154486673  /18-07-02","SEK","-64.78","114892.5","Doc 893","A497","2018-07-31 09:55:52"
"1240","2018-07-02","8444658243  /18-06-30","8444658243  /18-06-30","8444658243  /18-06-30","SEK","-55.11","114957.28","Doc 1046","A772","2018-07-31 09:55:52"
"1239","2018-07-02","Ccögoogle Co/18-07-01","Ccögoogle Co/18-07-01","Ccögoogle Co/18-07-01","SEK","-246.45","115012.39","Doc 890","A489","2018-07-31 09:55:52"
"1238","2018-07-02","6463978051  /18-06-30","6463978051  /18-06-30","6463978051  /18-06-30","SEK","-51.5","115258.84","Doc 895","A491","2018-07-31 09:55:52"
"1237","2018-07-02","Trygg-Hansa","Trygg-Hansa","Trygg-Hansa","SEK","-301","115310.34","","A898","2018-07-31 09:55:52"
"1236","2018-06-29","8778877815  /18-06-26","8778877815  /18-06-26","8778877815  /18-06-26","SEK","-138.89","115611.34","Doc 883","A493","2018-07-31 09:55:52"
"1235","2018-06-29","3122815333  /18-06-28","3122815333  /18-06-28","3122815333  /18-06-28","SEK","-916.68","115750.23","Doc 889","A492","2018-07-31 09:55:52"
"1234","2018-06-28","Sj Mobilapp /18-06-27","Sj Mobilapp /18-06-27","Sj Mobilapp /18-06-27","SEK","-475","116666.91","Doc 888","A467","2018-07-31 09:55:52"
"1233","2018-06-28","Sj Mobilapp /18-06-27","Sj Mobilapp /18-06-27","Sj Mobilapp /18-06-27","SEK","-295","117141.91","Doc 887","A468","2018-07-31 09:55:52"
"1232","2018-06-28","Bg 759-8147","Bg 759-8147","Bg 759-8147","SEK","59375","117436.91","","","2018-07-31 09:55:51"
"1231","2018-06-27","4158004537  /18-06-24","4158004537  /18-06-24","4158004537  /18-06-24","SEK","-263.81","58061.91","Doc 873","A495","2018-07-31 09:55:51"
"1230","2018-06-27","Kostnad","Kostnad","Kostnad","SEK","-35","58325.72","","A607","2018-07-31 09:55:51"
"1229","2018-06-27","281788582286","281788582286","281788582286","SEK","-46545.7","58360.72","Doc 850","A600","2018-07-31 09:55:51"
"1228","2018-06-26","Norrsken Hou/18-06-25","Norrsken Hou/18-06-25","Norrsken Hou/18-06-25","SEK","-11250","104906.42","Doc 870","A494","2018-07-31 09:55:51"
"1227","2018-06-26","52223425127","52223425127","Everyday AB","SEK","-56000","116156.42","","A459","2018-07-31 09:55:51"
"1218","2018-06-25","4154486673  /18-06-23","4154486673  /18-06-23","4154486673  /18-06-23","SEK","-227.91","172156.42","Doc 871","A409","2018-06-26 12:18:26"
"1217","2018-06-25","Grand Cayman/18-06-23","Grand Cayman/18-06-23","Grand Cayman/18-06-23","SEK","-8022.23","172384.33","Doc 872","A410","2018-06-26 12:18:26"
"1216","2018-06-25","R88-P187","R88-P187","Lön","SEK","-16333","180406.56","Rep 88","A608","2018-06-26 12:18:26"
"1215","2018-06-25","R88-P186","R88-P186","Lön","SEK","-30182","196739.56","Rep 88","A609","2018-06-26 12:18:26"
"1214","2018-06-25","R88-P188","R88-P188","Lön","SEK","-26170","226921.56","Rep 88","A610","2018-06-26 12:18:26"
"1213","2018-06-21","8778877815  /18-06-20","8778877815  /18-06-20","8778877815  /18-06-20","SEK","-945.97","253091.56","Doc 877","A413","2018-06-26 12:18:26"
"1212","2018-06-20","Cafe Saturnu/18-06-19","Cafe Saturnu/18-06-19","Cafe Saturnu/18-06-19","SEK","-340","254037.53","Doc 868","A430","2018-06-26 12:18:25"
"1211","2018-06-18","8778877815  /18-06-17","8778877815  /18-06-17","8778877815  /18-06-17","SEK","-895.07","254377.53","Doc 876","A411","2018-06-26 12:18:25"
"1210","2018-06-15","34933184607 /18-06-12","34933184607 /18-06-12","34933184607 /18-06-12","SEK","-312.4","255272.6","Doc 859,Doc 878","A419","2018-06-26 12:18:25"
"1209","2018-06-14","8778877815  /18-06-11","8778877815  /18-06-11","8778877815  /18-06-11","SEK","-221.74","255585","Doc 858","A418","2018-06-26 12:18:25"
"1208","2018-06-14","8662781349  /18-06-13","8662781349  /18-06-13","8662781349  /18-06-13","SEK","-303.33","255806.74","Doc 861","A421","2018-06-26 12:18:25"
"1207","2018-06-13","Fsprg Uk    /18-06-12","Fsprg Uk    /18-06-12","Fsprg Uk    /18-06-12","SEK","-468.84","256110.07","Doc 1137","A446","2018-06-26 12:18:25"
"1206","2018-06-13","Tallinn     /18-06-12","Tallinn     /18-06-12","Tallinn     /18-06-12","SEK","-605.29","256578.91","Doc 860","A414","2018-06-26 12:18:25"
"1205","2018-06-13","2122557327  /18-06-12","2122557327  /18-06-12","2122557327  /18-06-12","SEK","-311.75","257184.2","Doc 975","A445","2018-06-26 12:18:25"
"1204","2018-06-12","Skatteverket","",,"SEK","-6510","257495.95","","A444,A934","2018-06-26 12:18:25"
"1203","2018-06-11","Cafe Saturnu/18-06-08","Cafe Saturnu/18-06-08","Cafe Saturnu/18-06-08","SEK","-127","264005.95","Doc 899","A443","2018-06-26 12:18:25"
"1202","2018-06-11","Linkedin-314/18-06-10","Linkedin-314/18-06-10","Linkedin-314/18-06-10","SEK","-669.99","264132.95","","A442","2018-06-26 12:18:25"
"1201","2018-06-08","164 Sats Spa/18-06-07","164 Sats Spa/18-06-07","164 Sats Spa/18-06-07","SEK","-300","264802.94","Doc 949","A441","2018-06-26 12:18:25"
"1200","2018-06-08","Establish Ab/18-06-07","Establish Ab/18-06-07","Establish Ab/18-06-07","SEK","-2230","265102.94","Doc 853","A604","2018-06-26 12:18:25"
"1199","2018-06-08","Everyda I6o7","Everyda I6o7","Everyda I6o7","SEK","6983.51","267332.94","","A611","2018-06-26 12:18:25"
"1198","2018-06-08","D846-P184","D846-P184","Utlägg","SEK","-669.99","260349.43","Doc 846","A394","2018-06-26 12:18:25"
"1197","2018-06-08","Klientmedel Billogram AB","",,"SEK","-1244","261019.42","Doc 815","A393","2018-06-26 12:18:25"
"1196","2018-06-07","La Mirada   /18-06-05","La Mirada   /18-06-05","La Mirada   /18-06-05","SEK","-260.21","262263.42","Doc 1035","A440","2018-06-26 12:18:25"
"1195","2018-06-07","Bread And Ta/18-06-06","Bread And Ta/18-06-06","Bread And Ta/18-06-06","SEK","-228","262523.63","Doc 851","A602","2018-06-26 12:18:25"
"1194","2018-06-07","Cumin Club  /18-06-06","Cumin Club  /18-06-06","Cumin Club  /18-06-06","SEK","-560","262751.63","Doc 854","A606","2018-06-26 12:18:25"
"1193","2018-06-07","Kostnad","Kostnad","Kostnad","SEK","-400","263311.63","","A439,A592","2018-06-26 12:18:25"
"1192","2018-06-07","281588445132","281588445132","281588445132","SEK","-16456.8","263711.63","Doc 849","A438,A594","2018-06-26 12:18:25"
"1191","2018-06-07","Db Tt/cchelp/18-06-05","Db Tt/cchelp/18-06-05","Db Tt/cchelp/18-06-05","SEK","-104.73","280168.43","Doc 968","A437","2018-06-26 12:18:25"
"1183","2018-06-07","R84-P181","R84-P181","Lön","SEK","-30182","280273.16","Rep 84","A397","2018-06-26 12:18:23"
"1190","2018-06-05","Bg 759-8147","Bg 759-8147","Bg 759-8147","SEK","281250","310455.16","","","2018-06-26 12:18:24"
"1189","2018-06-04","4154486673  /18-06-02","4154486673  /18-06-02","4154486673  /18-06-02","SEK","-63.67","29205.16","Doc 847","A415","2018-06-26 12:18:24"
"1188","2018-06-04","Toronto     /18-06-02","Toronto     /18-06-02","Toronto     /18-06-02","SEK","-90.77","29268.83","","A436","2018-06-26 12:18:24"
"1187","2018-06-04","R84-P182","R84-P182","Lön","SEK","-26170","29359.6","Rep 84","A398","2018-06-26 12:18:24"
"1186","2018-06-04","Hi3g","Hi3g","Hi3g","SEK","-875","55529.6","","A435","2018-06-26 12:18:24"
"1185","2018-06-04","Linkedin-386/18-06-01","Linkedin-386/18-06-01","Linkedin-386/18-06-01","SEK","-62.28","56404.6","","A434","2018-06-26 12:18:24"
"1184","2018-06-04","Ccögoogle Co/18-06-01","Ccögoogle Co/18-06-01","Ccögoogle Co/18-06-01","SEK","-188.88","56466.88","Doc 841","A417","2018-06-26 12:18:24"
"1182","2018-06-04","6463978051  /18-06-01","6463978051  /18-06-01","6463978051  /18-06-01","SEK","-50.57","56655.76","Doc 1044","A433","2018-06-26 12:18:23"
"1181","2018-06-01","Facebk  Er7t/18-05-31","Facebk  Er7t/18-05-31","Facebk  Er7t/18-05-31","SEK","-1024.35","56706.33","","A432","2018-06-26 12:18:23"
"1180","2018-06-01","Trygg-Hansa","Trygg-Hansa","Trygg-Hansa","SEK","-301","57730.68","","A431","2018-06-26 12:18:23"
"1179","2018-05-31","Bruce       /18-05-30","Bruce       /18-05-30","Bruce       /18-05-30","SEK","-690","58031.68","Doc 900","A391","2018-06-26 12:18:23"
"1178","2018-05-31","8444658243  /18-05-30","8444658243  /18-05-30","8444658243  /18-05-30","SEK","-54.64","58721.68","Doc 1043","A390","2018-06-26 12:18:22"
"1177","2018-05-31","Bg 759-8147","Bg 759-8147","Bg 759-8147","SEK","3600","58776.32","","A388","2018-06-26 12:18:22"
"1172","2018-05-29","3122815333  /18-05-28","3122815333  /18-05-28","3122815333  /18-05-28","SEK","-895.06","55176.32","Doc 832","A349","2018-05-31 09:28:38"
"1171","2018-05-29","Bg 759-8147","Bg 759-8147","Bg 759-8147","SEK","19470","56071.38","","A324","2018-05-31 09:28:38"
"1170","2018-05-28","Norrsken Hou/18-05-26","Norrsken Hou/18-05-26","Norrsken Hou/18-05-26","SEK","-11250","36601.38","Doc 828","A357","2018-05-31 09:28:38"
"1169","2018-05-28","4158004537  /18-05-24","4158004537  /18-05-24","4158004537  /18-05-24","SEK","-261.09","47851.38","Doc 830","A350","2018-05-31 09:28:38"
"1168","2018-05-25","R81-P180","R81-P180","Lön","SEK","-11363","48112.47","Rep 81","A333","2018-05-31 09:28:38"
"1167","2018-05-24","4154486673  /18-05-23","4154486673  /18-05-23","4154486673  /18-05-23","SEK","-225.55","59475.47","Doc 829","A351","2018-05-31 09:28:38"
"1166","2018-05-21","8778877815  /18-05-20","8778877815  /18-05-20","8778877815  /18-05-20","SEK","-440.3","59701.02","Doc 836","A352","2018-05-31 09:28:38"
"1165","2018-05-18","8778877815  /18-05-17","8778877815  /18-05-17","8778877815  /18-05-17","SEK","-888.3","60141.32","Doc 835","A353","2018-05-31 09:28:38"
"1164","2018-05-17","Skatteverket","Skatteverket",,"SEK","-1750","61029.62","","A329","2018-05-31 09:28:37"
"1163","2018-05-16","Skatteverket","",,"SEK","-22223","62779.62","","A335","2018-05-31 09:28:37"
"1162","2018-05-15","34933184607 /18-05-12","34933184607 /18-05-12","34933184607 /18-05-12","SEK","-315.97","85002.62","Doc 881","A378","2018-05-31 09:28:37"
"1161","2018-05-14","8778877815  /18-05-11","8778877815  /18-05-11","8778877815  /18-05-11","SEK","-221.97","85318.59","Doc 822","A361","2018-05-31 09:28:37"
"1160","2018-05-14","2122557327  /18-05-12","2122557327  /18-05-12","2122557327  /18-05-12","SEK","-310.76","85540.56","Doc 823","A360","2018-05-31 09:28:37"
"1159","2018-05-14","Tallinn     /18-05-12","Tallinn     /18-05-12","Tallinn     /18-05-12","SEK","-611.15","85851.32","Doc 824","A354","2018-05-31 09:28:37"
"1158","2018-05-11","8662781349  /18-05-10","8662781349  /18-05-10","8662781349  /18-05-10","SEK","-304.91","86462.47","Doc 813","A377","2018-05-31 09:28:36"
"1157","2018-05-11","Skatteverket","",,"SEK","-47408","86767.38","","A334","2018-05-31 09:28:36"
"1156","2018-05-09","Klientmedel Billogram AB","",,"SEK","-1244","134175.38","Doc 771","A338","2018-05-31 09:28:36"
"1155","2018-05-08","Facebk  Ybhf/18-05-07","Facebk  Ybhf/18-05-07","Facebk  Ybhf/18-05-07","SEK","-2100","135419.38","Doc 811","A366","2018-05-31 09:28:36"
"1154","2018-05-08","Kostnad","Kostnad","Kostnad","SEK","-50","137519.38","","A379,A625","2018-05-31 09:28:36"
"1153","2018-05-08","281288259257","281288259257","281288259257","SEK","-39215.16","137569.38","Doc 795","A376","2018-05-31 09:28:36"
"1152","2018-05-07","Sverigetaxi /18-05-04","Sverigetaxi /18-05-04","Sverigetaxi /18-05-04","SEK","-118","176784.54","Doc 808","A363","2018-05-31 09:28:36"
"1151","2018-05-07","Db Tt/cchelp/18-05-05","Db Tt/cchelp/18-05-05","Db Tt/cchelp/18-05-05","SEK","-107.96","176902.54","","A375","2018-05-31 09:28:36"
"1150","2018-05-07","Facebk  V7nq/18-04-30","Facebk  V7nq/18-04-30","Facebk  V7nq/18-04-30","SEK","-498.34","177010.5","Doc 798","A355","2018-05-31 09:28:36"
"1149","2018-05-07","Hi3g","Hi3g","Hi3g","SEK","-999","177508.84","Doc 805","A330","2018-05-31 09:28:36"
"1148","2018-05-07","La Mirada   /18-05-04","La Mirada   /18-05-04","La Mirada   /18-05-04","SEK","-263.4","178507.84","Doc 1037","A374","2018-05-31 09:28:36"
"1147","2018-05-04","Apple Online/18-05-04","Apple Online/18-05-04","Apple Online/18-05-04","SEK","-999","178771.24","Doc 812","A339","2018-05-31 09:28:36"
"1133","2018-05-03","Toronto     /18-05-02","Toronto     /18-05-02","Toronto     /18-05-02","SEK","-91.36","179770.24","Doc 806","A368","2018-05-04 15:57:04"
"1132","2018-05-03","441282798545/18-05-02","441282798545/18-05-02","441282798545/18-05-02","SEK","118.27","179861.6","","A380","2018-05-04 15:57:04"
"1131","2018-05-03","Sj Mobilapp /18-05-02","Sj Mobilapp /18-05-02","Sj Mobilapp /18-05-02","SEK","-197","179743.33","Doc 803","A373","2018-05-04 15:57:03"
"1130","2018-05-03","4154486673  /18-05-02","4154486673  /18-05-02","4154486673  /18-05-02","SEK","-64.08","179940.33","Doc 814","A369","2018-05-04 15:57:03"
"1129","2018-05-02","Linkedin-379/18-05-01","Linkedin-379/18-05-01","Linkedin-379/18-05-01","SEK","-148.41","180004.41","","A372","2018-05-04 15:57:02"
"1128","2018-05-02","Ccögoogle Co/18-05-02","Ccögoogle Co/18-05-02","Ccögoogle Co/18-05-02","SEK","-188.73","180152.82","Doc 801","A371","2018-05-04 15:57:02"
"1127","2018-05-02","6463978051  /18-05-01","6463978051  /18-05-01","6463978051  /18-05-01","SEK","-50.55","180341.55","Doc 800","A367","2018-05-04 15:57:02"
"1126","2018-05-02","Trygg-Hansa","Trygg-Hansa","Trygg-Hansa","SEK","-301","180392.1","","A370","2018-05-04 15:57:02"
"1125","2018-05-02","Klientmedel Billogram AB","",,"SEK","-350","180693.1","Doc 794","A259","2018-05-04 15:57:02"
"1124","2018-04-30","Bruce       /18-04-29","Bruce       /18-04-29","Bruce       /18-04-29","SEK","-690","181043.1","Doc 901","A290","2018-05-04 15:57:02"
"1123","2018-04-30","3122815333  /18-04-28","3122815333  /18-04-28","3122815333  /18-04-28","SEK","-886.67","181733.1","Doc 797","A291","2018-05-04 15:57:01"
"1122","2018-04-27","Linkedin-378/18-04-26","Linkedin-378/18-04-26","Linkedin-378/18-04-26","SEK","-950.93","182619.77","Doc 852","A274","2018-05-04 15:57:01"
"1121","2018-04-27","Clm040109491","Clm040109491","Clm040109491","SEK","-500","183570.7","Doc 864","A273","2018-05-04 15:57:01"
"1120","2018-04-26","Norrsken Hou/18-04-25","Norrsken Hou/18-04-25","Norrsken Hou/18-04-25","SEK","-11250","184070.7","Doc 784","A289","2018-05-04 15:57:01"
"1119","2018-04-26","4158004537  /18-04-24","4158004537  /18-04-24","4158004537  /18-04-24","SEK","-254.63","195320.7","Doc 789","A288","2018-05-04 15:57:01"
"1118","2018-04-26","Wellington  /18-04-26","Wellington  /18-04-26","Wellington  /18-04-26","SEK","-342.43","195575.33","Doc 796","A287","2018-05-04 15:57:00"
"1117","2018-04-25","441282798545/18-04-22","441282798545/18-04-22","441282798545/18-04-22","SEK","-166.14","195917.76","Doc 786","A272","2018-05-04 15:57:00"
"1116","2018-04-25","Bg 759-8147","Bg 759-8147","Bg 759-8147","SEK","600","196083.9","","A236","2018-05-04 15:56:59"
"1115","2018-04-25","R71-P173","R71-P173","Lön","SEK","-30182","195483.9","Rep 71","A299","2018-05-04 15:56:59"
"1114","2018-04-25","R71-P174","R71-P174","Lön","SEK","-11363","225665.9","Rep 71","A297","2018-05-04 15:56:59"
"1113","2018-04-25","R71-P175","R71-P175","Lön","SEK","-26170","237028.9","Rep 71","A298","2018-05-04 15:56:59"
"1112","2018-04-24","Sj Mobilapp /18-04-23","Sj Mobilapp /18-04-23","Sj Mobilapp /18-04-23","SEK","-1084","263198.9","Doc 788","A256","2018-05-04 15:56:59"
"1111","2018-04-24","4154486673  /18-04-23","4154486673  /18-04-23","4154486673  /18-04-23","SEK","-217.89","264282.9","Doc 779","A286","2018-05-04 15:56:59"
"1110","2018-04-23","Bg 759-8147","Bg 759-8147","Bg 759-8147","SEK","10125","264500.79","","A237","2018-05-04 15:56:58"
"1109","2018-04-23","8778877815  /18-04-20","8778877815  /18-04-20","8778877815  /18-04-20","SEK","-424.97","254375.79","Doc 839","A271","2018-05-04 15:56:58"
"1108","2018-04-20","Sj Mobilapp /18-04-19","Sj Mobilapp /18-04-19","Sj Mobilapp /18-04-19","SEK","-465","254800.76","Doc 787","A257","2018-05-04 15:56:58"
"1107","2018-04-20","Everyday AB","Everyday AB","Everyday AB","SEK","139661","255265.76","","","2018-05-04 15:56:57"
"1106","2018-04-18","8778877815  /18-04-17","8778877815  /18-04-17","8778877815  /18-04-17","SEK","-855.08","115604.76","Doc 791","A285","2018-05-04 15:56:57"
"1105","2018-04-18","Kostnad","Kostnad","Kostnad","SEK","-35","116459.84","","A270,A623","2018-05-04 15:56:57"
"1104","2018-04-18","281088140846","281088140846","281088140846","SEK","-10019.45","116494.84","Doc 772","A284,A556","2018-05-04 15:56:57"
"1103","2018-04-18","Bg 759-8147","Bg 759-8147","Bg 759-8147","SEK","1100","126514.29","","A238","2018-05-04 15:56:54"
"1102","2018-04-17","Kostnad","Kostnad","Kostnad","SEK","-35","125414.29","","A269,A624","2018-05-04 15:56:54"
"1101","2018-04-17","281078122557","281078122557","281078122557","SEK","-4608.62","125449.29","Doc 770","A283","2018-05-04 15:56:53"
"1100","2018-04-16","34933184607 /18-04-12","34933184607 /18-04-12","34933184607 /18-04-12","SEK","-319.56","130057.91","Doc 782,Doc 882","A267","2018-05-04 15:56:53"
"1099","2018-04-16","3233752822  /18-04-14","3233752822  /18-04-14","3233752822  /18-04-14","SEK","-61.18","130377.47","Doc 783","A282","2018-05-04 15:56:53"
"1098","2018-04-16","8778877815  /18-04-11","8778877815  /18-04-11","8778877815  /18-04-11","SEK","-216.65","130438.65","Doc 780","A268","2018-05-04 15:56:52"
"1097","2018-04-13","Tallinn     /18-04-12","Tallinn     /18-04-12","Tallinn     /18-04-12","SEK","-616.13","130655.3","Doc 781","A266","2018-05-04 15:56:52"
"1096","2018-04-13","8662781349  /18-04-12","8662781349  /18-04-12","8662781349  /18-04-12","SEK","-295.68","131271.43","Doc 776","A281","2018-05-04 15:56:52"
"1095","2018-04-12","Skatteverket","",,"SEK","-47408","131567.11","","A260","2018-05-04 15:56:50"
"1094","2018-04-10","Alexander Awareness Tg","Faktura 1009913","Faktura 1009913","SEK","-170","178975.11","Doc 634","A265","2018-05-04 15:56:49"
"1093","2018-04-09","Everyday AB","Everyday AB","Everyday AB","SEK","13756.62","179145.11","","","2018-05-04 15:56:49"
"1092","2018-04-09","Klientmedel Billogram AB","",,"SEK","-1244","165388.49","Doc 604","A258","2018-05-04 15:56:49"
"1091","2018-04-09","Norrsken Hou/18-04-06","Norrsken Hou/18-04-06","Norrsken Hou/18-04-06","SEK","15241.94","166632.49","","A296","2018-05-04 15:56:48"
"1090","2018-04-06","Db Tt/cchelp/18-04-05","Db Tt/cchelp/18-04-05","Db Tt/cchelp/18-04-05","SEK","-105.42","151390.55","","A280","2018-05-04 15:56:47"
"1089","2018-04-05","La Mirada   /18-04-04","La Mirada   /18-04-04","La Mirada   /18-04-04","SEK","-250.2","151495.97","","A279","2018-05-04 15:56:45"
"1088","2018-04-04","61383766284 /18-04-03","61383766284 /18-04-03","61383766284 /18-04-03","SEK","-249.72","151746.17","","A278","2018-05-04 15:56:44"
"1087","2018-04-04","Bg 759-8147","Bg 759-8147","Bg 759-8147","SEK","3900","151995.89","","","2018-05-04 15:56:43"
"1086","2018-04-03","Toronto     /18-04-02","Toronto     /18-04-02","Toronto     /18-04-02","SEK","-85.89","148095.89","Doc 721","A277","2018-05-04 15:56:42"
"1085","2018-04-03","4154486673  /18-04-02","4154486673  /18-04-02","4154486673  /18-04-02","SEK","-60.25","148181.78","Doc 724","A264","2018-05-04 15:56:42"
"1084","2018-04-03","Hi3g","Hi3g","Hi3g","SEK","-999","148242.03","","A263","2018-05-04 15:56:41"
"1083","2018-04-03","Trygg-Hansa","Trygg-Hansa","Trygg-Hansa","SEK","-301","149241.03","","A276","2018-05-04 15:56:41"
"1082","2018-04-03","Bruce       /18-04-01","Bruce       /18-04-01","Bruce       /18-04-01","SEK","-690","149542.03","Doc 902","A275","2018-05-04 15:56:40"
"1081","2018-04-03","Ccögoogle Co/18-04-02","Ccögoogle Co/18-04-02","Ccögoogle Co/18-04-02","SEK","-252.45","150232.03","Doc 790","A262","2018-05-04 15:56:39"
"1080","2018-04-03","6463978051  /18-04-01","6463978051  /18-04-01","6463978051  /18-04-01","SEK","-47.65","150484.48","Doc 658","A261","2018-05-04 15:56:39"
"1079","2018-03-29","3122815333  /18-03-28","3122815333  /18-03-28","3122815333  /18-03-28","SEK","-845.13","150532.13","Doc 645","A245","2018-05-04 15:56:39"
"1078","2018-03-28","Bg 759-8147","Bg 759-8147","Bg 759-8147","SEK","2200","151377.26","","","2018-05-04 15:56:38"
"1077","2018-03-27","Bg 759-8147","Bg 759-8147","Bg 759-8147","SEK","1100","149177.26","","","2018-05-04 15:56:38"
"1076","2018-03-26","4158004537  /18-03-24","4158004537  /18-03-24","4158004537  /18-03-24","SEK","-246.23","148077.26","Doc 643","A244","2018-05-04 15:56:38"
"1075","2018-03-26","440128279854/18-03-22","440128279854/18-03-22","440128279854/18-03-22","SEK","-161.32","148323.49","Doc 630","A243","2018-05-04 15:56:38"
"1074","2018-03-26","Kostnad","Kostnad","Kostnad","SEK","-35","148484.81","","A242,A572","2018-05-04 15:56:38"
"1073","2018-03-26","280857991514","280857991514","280857991514","SEK","-9839.55","148519.81","Doc 605","A241,A503","2018-05-04 15:56:38"
"1072","2018-03-26","Kreditfa 202","Kreditfa 202","Acroyoga","SEK","-1100","158359.36","Doc 633","A240","2018-05-04 15:56:38"
"1071","2018-03-26","Alexander Awareness Tg","Faktura 1009913","Faktura 1009913","SEK","-680","159459.36","Doc 634","A239","2018-05-04 15:56:38"
"1052","2018-03-23","Bg 759-8147","Bg 759-8147","Bg 759-8147","SEK","2800","160139.36","","A123","2018-03-24 11:25:57"
"1051","2018-03-23","R65-P169","R65-P169","Lön","SEK","-11363","157339.36","Rep 65","A186","2018-03-24 11:25:56"
"1050","2018-03-23","R65-P168","R65-P168","Lön","SEK","-30182","168702.36","Rep 65","A188","2018-03-24 11:25:56"
"1049","2018-03-23","R65-P170","R65-P170","Lön","SEK","-26170","198884.36","Rep 65","A187","2018-03-24 11:25:56"
"1048","2018-03-23","Biljettkiosken","Yeos Summit Per",,"SEK","-4898","225054.36","Doc 503","A400","2018-03-24 11:25:56"
"1047","2018-03-22","Bg 759-8147","Bg 759-8147","Bg 759-8147","SEK","600","229952.36","","A124","2018-03-24 11:25:56"
"1046","2018-03-22","Account Factory Sweden A","",,"SEK","-7603","229352.36","Doc 421","A167","2018-03-24 11:25:56"
"1045","2018-03-21","Norrsken Hou/18-03-20","Norrsken Hou/18-03-20","Norrsken Hou/18-03-20","SEK","-11250","236955.36","Doc 682","A170","2018-03-24 11:25:56"
"1044","2018-03-21","8778877815  /18-03-20","8778877815  /18-03-20","8778877815  /18-03-20","SEK","-359.01","248205.36","Doc 656","A425","2018-03-24 11:25:56"
"1043","2018-03-21","Bg 759-8147","Bg 759-8147","Bg 759-8147","SEK","2800","248564.37","","A125","2018-03-24 11:25:56"
"1042","2018-03-20","Grafant AB","Faktura 1100","Faktura 1100","SEK","-31250","245764.37","Doc 462","A322","2018-03-24 11:25:56"
"1041","2018-03-19","Indian Stori/18-03-17","Indian Stori/18-03-17","Indian Stori/18-03-17","SEK","-888","277014.37","Doc 616","A527","2018-03-24 11:25:55"
"1040","2018-03-19","Ecoist Butik/18-03-17","Ecoist Butik/18-03-17","Ecoist Butik/18-03-17","SEK","-494","277902.37","Doc 614","A519","2018-03-24 11:25:55"
"1039","2018-03-19","Fikeriet    /18-03-17","Fikeriet    /18-03-17","Fikeriet    /18-03-17","SEK","-68","278396.37","Doc 615","A523","2018-03-24 11:25:55"
"1038","2018-03-19","8778877815  /18-03-17","8778877815  /18-03-17","8778877815  /18-03-17","SEK","-833.09","278464.37","Doc 622","A172","2018-03-24 11:25:55"
"1037","2018-03-19","Fikeriet    /18-03-18","Fikeriet    /18-03-18","Fikeriet    /18-03-18","SEK","-579","279297.46","Doc 618","A521","2018-03-24 11:25:55"
"1036","2018-03-19","Enskedeparke/18-03-18","Enskedeparke/18-03-18","Enskedeparke/18-03-18","SEK","-320","279876.46","Doc 617","A531","2018-03-24 11:25:55"
"1035","2018-03-19","Bg 759-8147","Bg 759-8147","Bg 759-8147","SEK","119850","280196.46","","","2018-03-24 11:25:55"
"1034","2018-03-16","Bg 759-8147","Bg 759-8147","Bg 759-8147","SEK","600","160346.46","","","2018-03-24 11:25:54"
"1033","2018-03-15","34933184607 /18-03-12","34933184607 /18-03-12","34933184607 /18-03-12","SEK","-312.67","159746.46","Doc 610","A210","2018-03-24 11:25:54"
"1032","2018-03-15","Bg 759-8147","Bg 759-8147","Bg 759-8147","SEK","1700","160059.13","","","2018-03-24 11:25:54"
"1031","2018-03-14","8662781349  /18-03-13","8662781349  /18-03-13","8662781349  /18-03-13","SEK","-288.97","158359.13","Doc 711","A212","2018-03-24 11:25:54"
"1030","2018-03-14","Bg 759-8147","Bg 759-8147","Bg 759-8147","SEK","1200","158648.1","","","2018-03-24 11:25:54"
"1029","2018-03-13","Amolloyacroy","Amolloyacroy","Amolloyacroy","SEK","1100","157448.1","Doc 702","A190,A320","2018-03-24 11:25:54"
"1028","2018-03-13","Skatteverket","",,"SEK","-49251","156348.1","","A131","2018-03-24 11:25:54"
"1027","2018-03-13","Skatteverket","Skatteverket",,"SEK","-27000","205599.1","","A130","2018-03-24 11:25:54"
"1026","2018-03-12","Kostnad","Kostnad","Kostnad","SEK","-50","232599.1","Doc 775","A526","2018-03-24 11:25:54"
"1025","2018-03-12","280717908659","280717908659","280717908659","SEK","-29481.21","232649.1","Doc 608","A153","2018-03-24 11:25:54"
"1024","2018-03-12","Bg 759-8147","Bg 759-8147","Bg 759-8147","SEK","1100","262130.31","","","2018-03-24 11:25:53"
"1023","2018-03-12","Skatteverket","",,"SEK","-24037","261030.31","","A129","2018-03-24 11:25:53"
"1022","2018-03-12","Skatteverket","",,"SEK","-625","285067.31","","A128","2018-03-24 11:25:53"
"1021","2018-03-12","Klientmedel Billogram AB","",,"SEK","-1244","285692.31","Doc 509","A146","2018-03-24 11:25:53"
"1020","2018-03-06","Norrsken Hou/18-03-05","Norrsken Hou/18-03-05","Norrsken Hou/18-03-05","SEK","-11250","286936.31","Doc 588","A152","2018-03-24 11:25:53"
"1019","2018-03-06","Dublin      /18-03-05","Dublin      /18-03-05","Dublin      /18-03-05","SEK","-104.62","298186.31","Doc 715","A189","2018-03-24 11:25:53"
"1018","2018-03-06","Bg 759-8147","Bg 759-8147","Bg 759-8147","SEK","500","298290.93","","","2018-03-24 11:25:53"
"1017","2018-03-06","Kostnad","Kostnad","Kostnad","SEK","-65","297790.93","Doc 774","A529","2018-03-24 11:25:52"
"1016","2018-03-06","H06373376389","H06373376389","H06373376389","SEK","1100","297855.93","","A530","2018-03-24 11:25:52"
"1015","2018-03-06","Hi3g","Hi3g","Hi3g","SEK","-848","296755.93","Doc 593","A133","2018-03-24 11:25:52"
"1014","2018-03-05","Toronto     /18-03-02","Toronto     /18-03-02","Toronto     /18-03-02","SEK","-91.3","297603.93","Doc 677","A219","2018-03-24 11:25:52"
"1013","2018-03-05","La Mirada   /18-03-02","La Mirada   /18-03-02","La Mirada   /18-03-02","SEK","-246.3","297695.23","Doc 680","A211","2018-03-24 11:25:52"
"1012","2018-03-05","4154486673  /18-03-02","4154486673  /18-03-02","4154486673  /18-03-02","SEK","-59.46","297941.53","Doc 601","A180","2018-03-24 11:25:52"
"1011","2018-03-02","Ccögoogle Co/18-03-02","Ccögoogle Co/18-03-02","Ccögoogle Co/18-03-02","SEK","-231.19","298000.99","Doc 600","A509","2018-03-24 11:25:52"
"1010","2018-03-02","6463978051  /18-02-28","6463978051  /18-02-28","6463978051  /18-02-28","SEK","-295.98","298232.18","Doc 705","A213","2018-03-24 11:25:52"
"1009","2018-03-02","Bg 759-8147","Bg 759-8147","Bg 759-8147","SEK","18750","298528.16","","","2018-03-24 11:25:52"
"1008","2018-03-02","Relationell Utveckling I","","82196","SEK","-1585","279778.16","Doc 508","A206","2018-03-24 11:25:52"
"1007","2018-03-01","3122815333  /18-02-28","3122815333  /18-02-28","3122815333  /18-02-28","SEK","-843.52","281363.16","Doc 706","A205","2018-03-24 11:25:52"
"1006","2018-03-01","Trygg-Hansa","Trygg-Hansa","Trygg-Hansa","SEK","-311","282206.68","Doc 666","A220","2018-03-24 11:25:52"
"1005","2018-02-27","Skatteverket","",,"SEK","-6429","282517.68","","A122","2018-03-24 11:25:52"
"1004","2018-02-27","Skatteverket","Skatt",,"SEK","-2300","288946.68","","A107","2018-03-24 11:25:51"
"1003","2018-02-26","4158004537  /18-02-24","4158004537  /18-02-24","4158004537  /18-02-24","SEK","-243.27","291246.68","Doc 585","A105","2018-03-24 11:25:51"
"1002","2018-02-26","440128279854/18-02-22","440128279854/18-02-22","440128279854/18-02-22","SEK","-159.39","291489.95","Doc 584","A112","2018-03-24 11:25:51"
"1001","2018-02-26","8778877815  /18-02-21","8778877815  /18-02-21","8778877815  /18-02-21","SEK","-1006.65","291649.34","","A121","2018-03-24 11:25:51"
"1000","2018-02-23","R59-P163","R59-P163","Lön","SEK","-30182","292655.99","Rep 59","A103,A202","2018-03-24 11:25:51"
"999","2018-02-23","R59-P162","R59-P162","Lön","SEK","-9520","322837.99","Rep 59","A101,A201","2018-03-24 11:25:51"
"998","2018-02-23","R59-P164","R59-P164","Lön","SEK","-26170","332357.99","Rep 59","A120,A200","2018-03-24 11:25:51"
"997","2018-02-21","Yogayama AB","",,"SEK","-2800","358527.99","Doc 580","A100","2018-03-24 11:25:50"
"996","2018-02-20","Sj Internetb/18-02-19","Sj Internetb/18-02-19","Sj Internetb/18-02-19","SEK","-1110","361327.99","","A118","2018-03-24 11:25:50"
"995","2018-02-19","8778877815  /18-02-17","8778877815  /18-02-17","8778877815  /18-02-17","SEK","-808.83","362437.99","Doc 590","A117,A571","2018-03-24 11:25:50"
"994","2018-02-16","Sj Mobilapp /18-02-15","Sj Mobilapp /18-02-15","Sj Mobilapp /18-02-15","SEK","-540","363246.82","Doc 569","A116,A517","2018-03-24 11:25:50"
"993","2018-02-16","3233752822  /18-02-14","3233752822  /18-02-14","3233752822  /18-02-14","SEK","-107.54","363786.82","Doc 567","A110,A570","2018-03-24 11:25:50"
"992","2018-02-16","Bg 759-8147","Bg 759-8147","Bg 759-8147","SEK","3600","363894.36","","","2018-03-24 11:25:50"
"991","2018-02-15","34933184607 /18-02-12","34933184607 /18-02-12","34933184607 /18-02-12","SEK","-308.4","360294.36","Doc 628","A108,A515","2018-03-24 11:25:50"
"990","2018-02-15","Iz  Tous Les/18-02-14","Iz  Tous Les/18-02-14","Iz  Tous Les/18-02-14","SEK","-60","360602.76","Doc 568","A114","2018-03-24 11:25:50"
"989","2018-02-15","3233752822  /18-02-13","3233752822  /18-02-13","3233752822  /18-02-13","SEK","-70.45","360662.76","Doc 559","A99","2018-03-24 11:25:50"
"988","2018-02-14","3233752822  /18-02-12","3233752822  /18-02-12","3233752822  /18-02-12","SEK","-70.14","360733.21","Doc 558","A115","2018-03-24 11:25:50"
"987","2018-02-13","8662781349  /18-02-12","8662781349  /18-02-12","8662781349  /18-02-12","SEK","-286.55","360803.35","Doc 712","A119","2018-03-24 11:25:50"
"986","2018-02-13","Skatteverket","Arbetsgivardek Janua",,"SEK","-45378","361089.9","","A102,A134","2018-03-24 11:25:50"
"985","2018-02-12","La Mirada   /18-02-10","La Mirada   /18-02-10","La Mirada   /18-02-10","SEK","-242.4","406467.9","Doc 679","A106","2018-03-24 11:25:50"
"946","2018-02-12","Frideborgsdotter,ingrid","","453","SEK","-3625","406710.3","Doc 481","A65","2018-02-12 08:04:50"
"945","2018-02-12","Bunnik      /18-02-09","Bunnik      /18-02-09","Bunnik      /18-02-09","SEK","-8604.15","410335.3","Doc 506","A75","2018-02-12 08:04:50"
"944","2018-02-09","Bruce       /18-02-08","Bruce       /18-02-08","Bruce       /18-02-08","SEK","-690","418939.45","Doc 510","A63","2018-02-12 08:04:50"
"943","2018-02-09","Banktjänster","Banktjänster","Banktjänster","SEK","-2250","419629.45","Doc 598","A85","2018-02-12 08:04:50"
"942","2018-02-09","Banktjänster","Banktjänster","Banktjänster","SEK","-87.5","421879.45","Doc 597","A155","2018-02-12 08:04:50"
"941","2018-02-09","Klientmedel Billogram AB","",,"SEK","-1244","421966.95","Doc 479","A49","2018-02-12 08:04:50"
"940","2018-02-08","Bg 759-8147","Bg 759-8147","Bg 759-8147","SEK","14250","423210.95","","","2018-02-12 08:04:50"
"939","2018-02-06","D2i Lejon Ta/18-02-05","D2i Lejon Ta/18-02-05","D2i Lejon Ta/18-02-05","SEK","-186","408960.95","Doc 505","A84","2018-02-12 08:04:50"
"938","2018-02-06","Dublin      /18-02-05","Dublin      /18-02-05","Dublin      /18-02-05","SEK","-101.09","409146.95","Doc 566","A156","2018-02-12 08:04:50"
"937","2018-02-05","Hi3g","Hi3g","Hi3g","SEK","-1005","409248.04","Doc 639","A81","2018-02-12 08:04:49"
"936","2018-02-05","Toronto     /18-02-02","Toronto     /18-02-02","Toronto     /18-02-02","SEK","-80.72","410253.04","Doc 502","A71","2018-02-12 08:04:49"
"935","2018-02-05","Order Moo Co/18-02-02","Order Moo Co/18-02-02","Order Moo Co/18-02-02","SEK","-264.05","410333.76","Doc 501","A157","2018-02-12 08:04:49"
"934","2018-02-05","3233752822  /18-02-01","3233752822  /18-02-01","3233752822  /18-02-01","SEK","-90.64","410597.81","Doc 498","A67","2018-02-12 08:04:49"
"933","2018-02-05","4154486673  /18-02-02","4154486673  /18-02-02","4154486673  /18-02-02","SEK","-56.85","410688.45","Doc 500","A69","2018-02-12 08:04:49"
"932","2018-02-02","Ccögoogle Co/18-02-01","Ccögoogle Co/18-02-01","Ccögoogle Co/18-02-01","SEK","-278.07","410745.3","Doc 499","A73","2018-02-12 08:04:49"
"931","2018-02-02","6463978051  /18-02-01","6463978051  /18-02-01","6463978051  /18-02-01","SEK","-309.63","411023.37","Doc 496","A58","2018-02-12 08:04:49"
"930","2018-02-01","Sj Mobilapp /18-01-31","Sj Mobilapp /18-01-31","Sj Mobilapp /18-01-31","SEK","-1750","411333","Doc 494","A160,A502","2018-02-12 08:04:49"
"929","2018-02-01","Wellington  /18-02-01","Wellington  /18-02-01","Wellington  /18-02-01","SEK","-139.12","413083","Doc 495","A56","2018-02-12 08:04:49"
"920","2018-02-01","Trygg-Hansa","Trygg-Hansa","Trygg-Hansa","SEK","-304","413222.12","Doc 579","A83,A550","2018-02-01 09:51:40"
"915","2018-01-31","52223425127","52223425127","Everyday AB","SEK","-55000","413526.12","","","2018-01-31 20:37:21"
"914","2018-01-31","52223425127","52223425127","Everyday AB","SEK","-31800","468526.12","","","2018-01-31 20:37:21"
"913","2018-01-31","Everyday AB","Everyday AB","Everyday AB","SEK","40000","500326.12","","","2018-01-31 20:37:21"
"912","2018-01-31","52223425127","52223425127","Everyday AB","SEK","-40000","460326.12","","","2018-01-31 20:37:21"
"911","2018-01-30","Wellington  /18-01-30","Wellington  /18-01-30","Wellington  /18-01-30","SEK","-120.85","500326.12","Doc 493","A20","2018-01-31 20:37:21"
"910","2018-01-30","Klientmedel Billogram AB","",,"SEK","-21875","500446.97","Doc 484","A51","2018-01-31 20:37:21"
"909","2018-01-29","Norrsken Hou/18-01-27","Norrsken Hou/18-01-27","Norrsken Hou/18-01-27","SEK","-7500","522321.97","Doc 492","A28,A552","2018-01-31 20:37:21"
"908","2018-01-29","3122815333  /18-01-28","3122815333  /18-01-28","3122815333  /18-01-28","SEK","-804.88","529821.97","Doc 491","A43","2018-01-31 20:37:21"
"907","2018-01-26","4158004537  /18-01-24","4158004537  /18-01-24","4158004537  /18-01-24","SEK","-235.85","530626.85","Doc 490","A21","2018-01-31 20:37:21"
"906","2018-01-25","9292907013  /18-01-23","9292907013  /18-01-23","9292907013  /18-01-23","SEK","32.83","530862.7","","A547","2018-01-31 20:37:21"
"905","2018-01-25","9292907013  /18-01-23","9292907013  /18-01-23","9292907013  /18-01-23","SEK","32.83","530829.87","","A548","2018-01-31 20:37:21"
"904","2018-01-25","9292907013  /18-01-23","9292907013  /18-01-23","9292907013  /18-01-23","SEK","32.83","530797.04","","A76","2018-01-31 20:37:20"
"903","2018-01-25","R57-P152","R57-P152","Lön","SEK","-26170","530764.21","Rep 57","A19","2018-01-31 20:37:20"
"902","2018-01-25","R57-P150","R57-P150","Lön","SEK","-9520","556934.21","Rep 57","A18","2018-01-31 20:37:20"
"901","2018-01-25","R57-P151","R57-P151","Lön","SEK","-26170","566454.21","Rep 57","A17","2018-01-31 20:37:20"
"900","2018-01-25","Yogayama","Yogayama","Yogayama","SEK","-536","592624.21","Doc 663","A143,A159","2018-01-31 20:37:20"
"899","2018-01-24","Iz  Tous Les/18-01-23","Iz  Tous Les/18-01-23","Iz  Tous Les/18-01-23","SEK","-55","593160.21","Doc 489","A27","2018-01-31 20:37:20"
"898","2018-01-24","Kostnad","Kostnad","Kostnad","SEK","-50","593215.21","","A138","2018-01-31 20:37:20"
"897","2018-01-24","280247625170","Invoice 447","Invoice 447","SEK","-32490.65","593265.21","Doc 448","A47,A54","2018-01-31 20:37:20"
"896","2018-01-24","Kostnad","Kostnad","Kostnad","SEK","-12","625755.86","","A41","2018-01-31 20:37:20"
"895","2018-01-24","280247625135","Workshop Movement: Jeppe Skovgaard","Workshop Movement: Jeppe Skovgaard","SEK","-4687.5","625767.86","Doc 487","A38","2018-01-31 20:37:20"
"894","2018-01-22","9292907013  /18-01-21","9292907013  /18-01-21","9292907013  /18-01-21","SEK","-32.98","630455.36","Doc 488","A22","2018-01-31 20:37:20"
"893","2018-01-22","Klientmedel Billogram AB","",,"SEK","-165","630488.34","Doc 471","A9","2018-01-31 20:37:20"
"892","2018-01-18","8778877815  /18-01-17","8778877815  /18-01-17","8778877815  /18-01-17","SEK","-818.75","630653.34","Doc 589","A79","2018-01-31 20:37:20"
"891","2018-01-17","Skatteverket","",,"SEK","-45432","631472.09","","","2018-01-31 20:37:20"
"890","2018-01-16","8662781349  /18-01-16","8662781349  /18-01-16","8662781349  /18-01-16","SEK","-282.19","676904.09","Doc 713","A78,A545","2018-01-31 20:37:20"
"889","2018-01-16","Bg 759-8147","Bg 759-8147","Bg 759-8147","SEK","12500","677186.28","","","2018-01-31 20:37:20"
"888","2018-01-12","Bg 759-8147","Bg 759-8147","Bg 759-8147","SEK","250000","664686.28","","","2018-01-31 20:37:20"
"887","2018-01-11","Bruce       /18-01-10","Bruce       /18-01-10","Bruce       /18-01-10","SEK","-690","414686.28","Doc 511","A61","2018-01-31 20:37:20"
"886","2018-01-11","D475-P148","D475-P148","10","SEK","-31250","415376.28","Doc 475","A40","2018-01-31 20:37:19"
"885","2018-01-10","Klientmedel Billogram AB","",,"SEK","-1244","446626.28","Doc 452","A39,A551","2018-01-31 20:37:19"
"884","2018-01-08","3233752822  /18-01-05","3233752822  /18-01-05","3233752822  /18-01-05","SEK","-181.92","447870.28","Doc 477","A23","2018-01-31 20:37:19"
"883","2018-01-08","Db Tt/cchelp/18-01-05","Db Tt/cchelp/18-01-05","Db Tt/cchelp/18-01-05","SEK","-100.68","448052.2","Doc 562","A44","2018-01-31 20:37:19"
"882","2018-01-08","3233752822  /18-01-04","3233752822  /18-01-04","3233752822  /18-01-04","SEK","-142.76","448152.88","Doc 476","A24","2018-01-31 20:37:19"
"881","2018-01-05","Fsprg Uk    /18-01-04","Fsprg Uk    /18-01-04","Fsprg Uk    /18-01-04","SEK","-418.47","448295.64","Doc 472","A29","2018-01-31 20:37:19"
"880","2018-01-05","Hi3g","Hi3g","Hi3g","SEK","-899","448714.11","Doc 638","A77,A139","2018-01-31 20:37:19"
"879","2018-01-03","Toronto     /18-01-02","Toronto     /18-01-02","Toronto     /18-01-02","SEK","-40.84","449613.11","Doc 469","A30","2018-01-31 20:37:19"
"878","2018-01-03","3233752822  /18-01-02","3233752822  /18-01-02","3233752822  /18-01-02","SEK","-271.45","449653.95","Doc 466","A91","2018-01-31 20:37:19"
"877","2018-01-03","4154486673  /18-01-02","4154486673  /18-01-02","4154486673  /18-01-02","SEK","-58.83","449925.4","Doc 468","A25","2018-01-31 20:37:19"
"876","2018-01-03","Bg 759-8147","Bg 759-8147","Bg 759-8147","SEK","106250","449984.23","","","2018-01-31 20:37:19"
"875","2018-01-03","Frida Brita Panoussis","","43","SEK","-11250","343734.23","Doc 450","A26","2018-01-31 20:37:19"
"874","2018-01-02","Ccögoogle Co/18-01-01","Ccögoogle Co/18-01-01","Ccögoogle Co/18-01-01","SEK","-274.32","354984.23","Doc 474","A53","2018-01-31 20:37:19"
"873","2018-01-02","Wellington  /18-01-02","Wellington  /18-01-02","Wellington  /18-01-02","SEK","-583.28","355258.55","Doc 465","A46","2018-01-31 20:37:19"
"872","2018-01-02","6463978051  /18-01-01","6463978051  /18-01-01","6463978051  /18-01-01","SEK","-178.19","355841.83","Doc 704","A142","2018-01-31 20:37:19"
"871","2018-01-02","8552364625  /18-01-01","8552364625  /18-01-01","8552364625  /18-01-01","SEK","-422.66","356020.02","Doc 714","A141","2018-01-31 20:37:19"
"870","2018-01-02","Nicole Lön","Nicole Lön","Nicole Lön","SEK","11255","356442.68","","A544","2018-01-31 20:37:19"
"869","2018-01-02","Trygg-Hansa","Trygg-Hansa","Trygg-Hansa","SEK","-304","345187.68","Doc 579","A90,A549","2018-01-31 20:37:19"
"862","2017-12-29","3122815333  /17-12-28","3122815333  /17-12-28","3122815333  /17-12-28","SEK","-839.7","345491.68","Doc 463","A823","2018-01-01 18:12:36"
"861","2017-12-29","R54-P144","R54-P144","Lön","SEK","-26131","346331.38","Rep 55","A963","2018-01-01 18:12:36"
"860","2017-12-28","Lön Everyday","Lön Everyday","Lön Everyday","SEK","25738","372462.38","","A959","2018-01-01 18:12:36"
"859","2017-12-28","R54-P143","R54-P143","Lön","SEK","-9520","346724.38","Rep 55","A851","2018-01-01 18:12:36"
"858","2017-12-28","Lön Nicole","Lön Nicole","Everyday","SEK","-11255","356244.38","","A960,A1026","2018-01-01 18:12:36"
"857","2017-12-28","Lön Ashkan","Lön Ashkan","Lön Everyday","SEK","-26054","367499.38","Rep 55","A962","2018-01-01 18:12:36"
"856","2017-12-28","Lön Per","Lön Per","Lön Everyday","SEK","-25738","393553.38","","","2018-01-01 18:12:36"
"855","2017-12-27","Bg 759-8147","Bg 759-8147","Bg 759-8147","SEK","1166","419291.38","","","2018-01-01 18:12:36"
"854","2017-12-27","4158004537  /17-12-24","4158004537  /17-12-24","4158004537  /17-12-24","SEK","-249.93","418125.38","Doc 461","A827","2018-01-01 18:12:36"
"851","2017-12-22","Dr Mat      /17-12-20","Dr Mat      /17-12-20","Dr Mat      /17-12-20","SEK","-375","418375.31","Doc 459","A817","2017-12-26 15:01:46"
"850","2017-12-22","9292907013  /17-12-21","9292907013  /17-12-21","9292907013  /17-12-21","SEK","-34.52","418750.31","Doc 460","A841","2017-12-26 15:01:46"
"849","2017-12-22","Yogayama","Yogayama","Yogayama","SEK","-1250","418784.83","Doc 661","A964","2017-12-26 15:01:46"
"848","2017-12-21","Espresso Sos/17-12-20","Espresso Sos/17-12-20","Espresso Sos/17-12-20","SEK","-124","420034.83","Doc 458","A816","2017-12-26 15:01:46"
"847","2017-12-21","8778877815  /17-12-20","8778877815  /17-12-20","8778877815  /17-12-20","SEK","-2204.89","420158.83","Doc 655","A969","2017-12-26 15:01:46"
"837","2017-12-18","Norrsken Hou/17-12-17","Norrsken Hou/17-12-17","Norrsken Hou/17-12-17","SEK","-7500","422363.72","Doc 455","A805","2017-12-21 13:00:18"
"836","2017-12-18","8778877815  /17-12-17","8778877815  /17-12-17","8778877815  /17-12-17","SEK","-864.16","429863.72","Doc 454","A804","2017-12-21 13:00:18"
"835","2017-12-12","8662781349  /17-12-11","8662781349  /17-12-11","8662781349  /17-12-11","SEK","-298.17","430727.88","Doc 453","A965","2017-12-21 13:00:17"
"834","2017-12-12","Skatteverket","",,"SEK","-44742","431026.05","","A833","2017-12-21 13:00:17"
"833","2017-12-11","Bg 759-8147","Bg 759-8147","Bg 759-8147","SEK","31250","475768.05","","","2017-12-21 13:00:17"
"832","2017-12-11","Dr Mat      /17-12-08","Dr Mat      /17-12-08","Dr Mat      /17-12-08","SEK","-500","444518.05","Doc 456","A806","2017-12-21 13:00:17"
"831","2017-12-08","Klientmedel Billogram AB","",,"SEK","-1244","445018.05","Doc 429","A795","2017-12-21 13:00:17"
"830","2017-12-07","Meat On A St/17-12-06","Meat On A St/17-12-06","Meat On A St/17-12-06","SEK","-320","446262.05","Doc 451","A807","2017-12-21 13:00:17"
"829","2017-12-07","Invoicesform/17-12-06","Invoicesform/17-12-06","Invoicesform/17-12-06","SEK","-4000","446582.05","Doc 449","A796","2017-12-21 13:00:17"
"828","2017-12-06","Db Tt/cchelp/17-12-05","Db Tt/cchelp/17-12-05","Db Tt/cchelp/17-12-05","SEK","-102.49","450582.05","Doc 565","A864","2017-12-21 13:00:17"
"827","2017-12-06","6033806747  /17-12-05","6033806747  /17-12-05","6033806747  /17-12-05","SEK","-1100.54","450684.54","Doc 708","A976","2017-12-21 13:00:17"
"826","2017-12-05","Bg 759-8147","Bg 759-8147","Bg 759-8147","SEK","31250","451785.08","","","2017-12-21 13:00:17"
"825","2017-12-05","Instinctly AB","Daniel Lauding",,"SEK","-30000","420535.08","Doc 446","A809","2017-12-21 13:00:17"
"824","2017-12-04","4154486673  /17-12-02","4154486673  /17-12-02","4154486673  /17-12-02","SEK","-60.18","450535.08","Doc 443","A877","2017-12-21 13:00:17"
"823","2017-12-04","Toronto     /17-12-02","Toronto     /17-12-02","Toronto     /17-12-02","SEK","-55.28","450595.26","Doc 441","A880","2017-12-21 13:00:17"
"822","2017-12-04","34933184607 /17-11-30","34933184607 /17-11-30","34933184607 /17-11-30","SEK","-306.96","450650.54","Doc 626","A973","2017-12-21 13:00:17"
"821","2017-12-04","273387334148","Invoice 446","Invoice 446","SEK","-22779.43","450957.5","Doc 436","A808","2017-12-21 13:00:17"
"820","2017-12-04","Kostnad","Kostnad","Kostnad","SEK","-50","473736.93","","A801","2017-12-21 13:00:17"
"819","2017-12-04","Hi3g","Hi3g","Hi3g","SEK","-802","473786.93","Doc 640","A966","2017-12-21 13:00:17"
"818","2017-12-04","Ccögoogle Co/17-12-02","Ccögoogle Co/17-12-02","Ccögoogle Co/17-12-02","SEK","-249.56","474588.93","Doc 442","A824","2017-12-21 13:00:16"
"817","2017-12-04","6463978051  /17-12-01","6463978051  /17-12-01","6463978051  /17-12-01","SEK","-54.16","474838.49","Doc 703","A975","2017-12-21 13:00:16"
"816","2017-12-04","8552364625  /17-12-01","8552364625  /17-12-01","8552364625  /17-12-01","SEK","-429.89","474892.65","Doc 438","A892","2017-12-21 13:00:16"
"815","2017-12-01","Trygg-Hansa","Trygg-Hansa","Trygg-Hansa","SEK","-304","475322.54","Doc 579","A862","2017-12-21 13:00:16"
"814","2017-11-30","Delutb Lån","Delutb Lån","Delutb Lån","SEK","400000","475626.54","Doc 625","A951","2017-12-21 13:00:16"
"813","2017-11-29","3122815333  /17-11-28","3122815333  /17-11-28","3122815333  /17-11-28","SEK","-846.6","75626.54","Doc 439","A943,A1118","2017-12-21 13:00:16"
"812","2017-11-28","Bg 759-8147","Bg 759-8147","Bg 759-8147","SEK","583","76473.14","","","2017-12-21 13:00:16"
"811","2017-11-27","4158004537  /17-11-24","4158004537  /17-11-24","4158004537  /17-11-24","SEK","-247.13","75890.14","Doc 437","A825","2017-12-21 13:00:16"
"810","2017-11-27","Stripe","Stripe","Stripe","SEK","35702","76137.27","Doc 647","A950","2017-12-21 13:00:16"
"809","2017-11-27","R52-P137","R52-P137","Lön","SEK","-20009","40435.27","Rep 52","A836","2017-12-21 13:00:16"
"808","2017-11-27","R52-P138","R52-P138","Lön","SEK","-20009","60444.27","Rep 52","A835","2017-12-21 13:00:16"
"807","2017-11-24","Everyday AB","Everyday AB","Everyday AB","SEK","25000","80453.27","","A834","2017-12-21 13:00:16"
"806","2017-11-24","R45-P135","R45-P135","Lön","SEK","-7447","55453.27","Rep 45","A838","2017-12-21 13:00:16"
"805","2017-11-24","R45-P133","R45-P133","Lön","SEK","-4760","62900.27","Rep 45","A837","2017-12-21 13:00:16"
"804","2017-11-24","D422-P131","D422-P131","Utlägg Every","SEK","-255","67660.27","Doc 422","A939","2017-12-21 13:00:16"
"803","2017-11-24","R45-P134","R45-P134","Lön","SEK","-7447","67915.27","Rep 45","A850","2017-12-21 13:00:16"
"802","2017-11-24","R45-P136","R45-P136","Lön","SEK","-10788","75362.27","Rep 45","A849","2017-12-21 13:00:16"
"801","2017-11-24","Yogayama","Yogayama","Yogayama","SEK","-1250","86150.27","Doc 660","A948","2017-12-21 13:00:16"
"784","2017-11-22","9292907013  /17-11-21","9292907013  /17-11-21","9292907013  /17-11-21","SEK","-34.95","87400.27","Doc 435","A843","2017-11-23 20:39:11"
"783","2017-11-21","Stripe      /17-11-20","Stripe      /17-11-20","Stripe      /17-11-20","SEK","-15000","87435.22","Doc 433","A897","2017-11-23 20:39:11"
"782","2017-11-21","8778877815  /17-11-20","8778877815  /17-11-20","8778877815  /17-11-20","SEK","-2224.73","102435.22","Doc 654","A949","2017-11-23 20:39:11"
"781","2017-11-21","Klientmedel Billogram AB","",,"SEK","-161","104659.95","Doc 412","A764","2017-11-23 20:39:11"
"780","2017-11-20","8778877815  /17-11-17","8778877815  /17-11-17","8778877815  /17-11-17","SEK","-858.17","104820.95","Doc 439","A886","2017-11-23 20:39:11"
"779","2017-11-17","Espresso Sos/17-11-15","Espresso Sos/17-11-15","Espresso Sos/17-11-15","SEK","-114","105679.12","Doc 718","A945","2017-11-23 20:39:11"
"778","2017-11-16","61383766284 /17-11-15","61383766284 /17-11-15","61383766284 /17-11-15","SEK","-163.53","105793.12","Doc 431,Doc 430","A832","2017-11-23 20:39:11"
"777","2017-11-15","Norrsken Hou/17-11-14","Norrsken Hou/17-11-14","Norrsken Hou/17-11-14","SEK","-15241.94","105956.65","Doc 684","A947","2017-11-23 20:39:11"
"776","2017-11-13","Bg 759-8147","Bg 759-8147","Bg 759-8147","SEK","260","121198.59","","","2017-11-23 20:39:11"
"775","2017-11-13","Skatteverket","",,"SEK","-99612","120938.59","","A765","2017-11-23 20:39:11"
"774","2017-11-10","8662781349  /17-11-09","8662781349  /17-11-09","8662781349  /17-11-09","SEK","-713.73","220550.59","Doc 419","A788","2017-11-23 20:39:11"
"773","2017-11-09","Loopia AB   /17-11-08","Loopia AB   /17-11-08","Loopia AB   /17-11-08","SEK","-407","221264.32","Doc 424","A766","2017-11-23 20:39:11"
"772","2017-11-09","Klientmedel Billogram AB","D395-P118",,"SEK","-1244","221671.32","Doc 395","A778","2017-11-23 20:39:11"
"771","2017-11-07","Bg 759-8147","Bg 759-8147","Bg 759-8147","SEK","583","222915.32","","","2017-11-23 20:39:11"
"770","2017-11-07","Siosepol AB","",,"SEK","-14000","222332.32","Doc 423","A779","2017-11-23 20:39:11"
"769","2017-11-07","Siosepol AB","",,"SEK","-12750","236332.32","Doc 344","A780","2017-11-23 20:39:11"
"768","2017-11-06","Db Tt/cchelp/17-11-05","Db Tt/cchelp/17-11-05","Db Tt/cchelp/17-11-05","SEK","-100.7","249082.32","Doc 564","A867","2017-11-23 20:39:11"
"767","2017-11-06","Hi3g","Hi3g","Hi3g","SEK","-1296","249183.02","Doc 637","A946","2017-11-23 20:39:11"
"766","2017-11-03","Toronto     /17-11-02","Toronto     /17-11-02","Toronto     /17-11-02","SEK","-86.01","250479.02","Doc 418","A786","2017-11-23 20:39:11"
"765","2017-11-03","34933184607 /17-10-31","34933184607 /17-10-31","34933184607 /17-10-31","SEK","-301.12","250565.03","Doc 627","A958","2017-11-23 20:39:11"
"764","2017-11-03","Paypal  Bioc/17-11-02","Paypal  Bioc/17-11-02","Paypal  Bioc/17-11-02","SEK","-6600","250866.15","Doc 414","A784","2017-11-23 20:39:11"
"763","2017-11-03","4154486673  /17-11-02","4154486673  /17-11-02","4154486673  /17-11-02","SEK","-60.32","257466.15","Doc 415","A772","2017-11-23 20:39:11"
"762","2017-11-02","Ccögoogle Co/17-11-02","Ccögoogle Co/17-11-02","Ccögoogle Co/17-11-02","SEK","-320.18","257526.47","Doc 413","A777","2017-11-23 20:39:10"
"761","2017-11-02","6463978051  /17-11-01","6463978051  /17-11-01","6463978051  /17-11-01","SEK","-111.35","257846.65","Doc 411","A775","2017-11-23 20:39:10"
"760","2017-11-02","A House At Östermalm AB","","10026789","SEK","-5650","257958","Doc 410","A846","2017-11-23 20:39:10"
"759","2017-11-01","61383766284 /17-10-31","61383766284 /17-10-31","61383766284 /17-10-31","SEK","-231.89","263608","Doc 710","A944","2017-11-23 20:39:10"
"758","2017-11-01","Trygg-Hansa","Trygg-Hansa","Trygg-Hansa","SEK","-259","263839.89","Doc 417","A776","2017-11-23 20:39:10"
"757","2017-10-30","Petach Tiqwa/17-10-27","Petach Tiqwa/17-10-27","Petach Tiqwa/17-10-27","SEK","-421.79","264098.89","Doc 408","A844","2017-11-23 20:39:10"
"756","2017-10-30","3122815333  /17-10-28","3122815333  /17-10-28","3122815333  /17-10-28","SEK","-852.2","264520.68","Doc 409","A782","2017-11-23 20:39:10"
"755","2017-10-30","Bg 759-8147","Bg 759-8147","Bg 759-8147","SEK","2225","265372.88","","","2017-11-23 20:39:10"
"748","2017-10-27","4158004537  /17-10-25","4158004537  /17-10-25","4158004537  /17-10-25","SEK","-247.41","263147.88","Doc 407","A627","2017-10-28 16:03:01"
"747","2017-10-27","Lön Per Jons","Lön Per Jons","Lön Per Jons","SEK","-38027","263395.29","Rep 43","A651","2017-10-28 16:03:01"
"746","2017-10-27","R40-P124","R40-P124","Lön","SEK","-13824","301422.29","Rep 40","A652","2017-10-28 16:03:01"
"745","2017-10-27","R40-P121","R40-P121","Lön","SEK","-7447","315246.29","Rep 40","A653","2017-10-28 16:03:01"
"744","2017-10-27","R41-P125","R41-P125","Lön","SEK","-6091","322693.29","Rep 41","A654","2017-10-28 16:03:01"
"743","2017-10-27","R40-P123","R40-P123","Lön","SEK","-10788","328784.29","Rep 40","A655","2017-10-28 16:03:01"
"742","2017-10-27","Teamtailor AB","D380-P117","2223","SEK","-4750","339572.29","Doc 380","A656","2017-10-28 16:03:01"
"741","2017-10-26","8778877815  /17-10-25","8778877815  /17-10-25","8778877815  /17-10-25","SEK","-507.74","344322.29","Doc 406","A615","2017-10-28 16:03:01"
"740","2017-10-26","R40-P122","R40-P122","Lön","SEK","-7447","344830.03","Rep 40","A657","2017-10-28 16:03:01"
"739","2017-10-26","R40-P120","R40-P120","Lön","SEK","-6529","352277.03","Rep 40","A658","2017-10-28 16:03:01"
"738","2017-10-25","Bg 759-8147","Bg 759-8147","Bg 759-8147","SEK","25000","358806.03","","","2017-10-28 16:03:01"
"737","2017-10-25","Yogayama","Yogayama","Yogayama","SEK","-1250","333806.03","Doc 662","A659","2017-10-28 16:03:01"
"736","2017-10-24","Bg 759-8147","Bg 759-8147","Bg 759-8147","SEK","7206","335056.03","","","2017-10-28 16:03:01"
"735","2017-10-23","Wellington  /17-10-22","Wellington  /17-10-22","Wellington  /17-10-22","SEK","-326.98","327850.03","Doc 400","A616","2017-10-28 16:03:00"
"734","2017-10-23","8778877815  /17-10-20","8778877815  /17-10-20","8778877815  /17-10-20","SEK","-2144.63","328177.01","Doc 653","A660","2017-10-28 16:03:00"
"733","2017-10-20","8662781349  /17-10-19","8662781349  /17-10-19","8662781349  /17-10-19","SEK","-772.4","330321.64","Doc 396","A662","2017-10-28 16:03:00"
"732","2017-10-19","Vimeo Com   /17-10-18","Vimeo Com   /17-10-18","Vimeo Com   /17-10-18","SEK","-2040","331094.04","Doc 560","A663","2017-10-28 16:03:00"
"731","2017-10-19","Norrsken Hou/17-10-18","Norrsken Hou/17-10-18","Norrsken Hou/17-10-18","SEK","-23750","333134.04","Doc 398","A640","2017-10-28 16:03:00"
"730","2017-10-19","Norrsken Hou/17-10-17","Norrsken Hou/17-10-17","Norrsken Hou/17-10-17","SEK","7500","356884.04","Doc 767","A664","2017-10-28 16:03:00"
"729","2017-10-17","Vimeo Com   /17-10-17","Vimeo Com   /17-10-17","Vimeo Com   /17-10-17","SEK","-80.75","349384.04","Doc 561","A665","2017-10-28 16:03:00"
"728","2017-10-13","Bg 759-8147","Bg 759-8147","Bg 759-8147","SEK","26016","349464.79","","","2017-10-28 16:03:00"
"727","2017-10-13","D394-P119","D394-P119","Externrep. P","SEK","-65","323448.79","Doc 394","A666","2017-10-28 16:03:00"
"726","2017-10-13","Göteborg Smarttravel Eko","D370-P111","29844","SEK","-1923","323513.79","Doc 370","A598","2017-10-28 16:03:00"
"725","2017-10-13","Klientmedel Billogram AB","D364-P94",,"SEK","-1244","325436.79","Doc 364","A667","2017-10-28 16:03:00"
"711","2017-10-12","D333-P97","D333-P97","D333-P97","SEK","-329.5","326680.79","Doc 333","A588","2017-10-12 16:31:44"
"710","2017-10-12","D375-P108","D375-P108","D375-P108","SEK","-7000","327010.29","Doc 375","A582","2017-10-12 16:31:43"
"709","2017-10-10","8778877815  /17-10-09","8778877815  /17-10-09","8778877815  /17-10-09","SEK","-44.59","334010.29","Doc 393","A620","2017-10-12 16:31:43"
"708","2017-10-09","8778877815  /17-10-07","8778877815  /17-10-07","8778877815  /17-10-07","SEK","-661.5","334054.88","Doc 676","A668","2017-10-12 16:31:43"
"707","2017-10-09","R37-P109","R37-P109","Lön","SEK","-10788","334716.38","Rep 37","A669","2017-10-12 16:31:43"
"706","2017-10-09","Hi3g","Hi3g","Hi3g","SEK","-927","345504.38","Doc 641","A670","2017-10-12 16:31:43"
"705","2017-10-06","415-986-7057/17-10-05","415-986-7057/17-10-05","415-986-7057/17-10-05","SEK","-97.83","346431.38","Doc 563","A671","2017-10-12 16:31:43"
"704","2017-10-06","Google  Goog/17-10-06","Google  Goog/17-10-06","Google  Goog/17-10-06","SEK","-19","346529.21","Doc 392","A617","2017-10-12 16:31:43"
"703","2017-10-06","Grafant AB","D348-P116","1088","SEK","-37500","346548.21","Doc 348","A583","2017-10-12 16:31:43"
"702","2017-10-06","Johan Blomborg","Faktura 120","Faktura 120","SEK","-27500","384048.21","Doc 306","A641","2017-10-12 16:31:43"
"701","2017-10-05","Upwork Com/b/17-10-04","Upwork Com/b/17-10-04","Upwork Com/b/17-10-04","SEK","-3856.74","411548.21","Doc 389","A618","2017-10-12 16:31:42"
"700","2017-10-05","R39-P115","R39-P115","Lön","SEK","-6529","415404.95","Rep 39","A672","2017-10-12 16:31:42"
"699","2017-10-05","D390-P114","D390-P114","Externrep. P","SEK","-100","421933.95","Doc 390","A587","2017-10-12 16:31:42"
"698","2017-10-05","D388-P113","D388-P113","Inköp Av Pro","SEK","-3856.76","422033.95","Doc 388","A581","2017-10-12 16:31:42"
"697","2017-10-04","8778877815  /17-10-02","8778877815  /17-10-02","8778877815  /17-10-02","SEK","-83.84","425890.71","Doc 385","A619","2017-10-04 19:42:47"
"696","2017-10-04","Loopia AB   /17-10-03","Loopia AB   /17-10-03","Loopia AB   /17-10-03","SEK","-129","425974.55","Doc 387","A621","2017-10-04 19:42:47"
"695","2017-10-04","R37-P107","R37-P107","Lön","SEK","-9547","426103.55","Rep 37","A673","2017-10-04 19:42:47"
"694","2017-10-04","R37-P105","R37-P105","Lön","SEK","-3919","435650.55","Rep 37","A674","2017-10-04 19:42:47"
"693","2017-10-03","Ccögoogle Co/17-10-02","Ccögoogle Co/17-10-02","Ccögoogle Co/17-10-02","SEK","-366.3","439569.55","Doc 386","A622","2017-10-04 19:42:47"
"692","2017-10-03","6463978051  /17-10-02","6463978051  /17-10-02","6463978051  /17-10-02","SEK","-29.38","439935.85","Doc 384","A675","2017-10-04 19:42:47"
"691","2017-10-03","4154486673  /17-10-02","4154486673  /17-10-02","4154486673  /17-10-02","SEK","-58.75","439965.23","Doc 383","A628","2017-10-04 19:42:47"
"690","2017-10-03","R37-P104","R37-P104","Lön","SEK","-7447","440023.98","Rep 37","A676","2017-10-04 19:42:47"
"689","2017-10-03","R37-P110","R37-P110","Lön","SEK","-20009","447470.98","Rep 37","A677","2017-10-04 19:42:47"
"688","2017-10-03","R37-P112","R37-P112","Lön","SEK","-13824","467479.98","Rep 37","A678","2017-10-04 19:42:47"
"687","2017-10-02","Skatteverket","Skatteverket",,"SEK","-20","481303.98","","A564,A679","2017-10-04 19:42:47"
"686","2017-10-02","35314369001 /17-09-29","35314369001 /17-09-29","35314369001 /17-09-29","SEK","-1091.46","481323.98","Doc 365","A599","2017-10-04 19:42:47"
"685","2017-10-02","Paypal  Jbki/17-09-29","Paypal  Jbki/17-09-29","Paypal  Jbki/17-09-29","SEK","-6600","482415.44","Doc 381","A597","2017-10-04 19:42:47"
"684","2017-10-02","D369-P96","D369-P96","Externrep. P","SEK","-278","489015.44","Doc 369","A569","2017-10-04 19:42:47"
"677","2017-09-29","D371-P95","D371-P95","D371-P95","SEK","-320","489293.44","Doc 371","A568","2017-09-29 17:16:27"
"676","2017-09-28","Delutb Lån","Delutb Lån","Delutb Lån","SEK","400000","489613.44","Doc 769,Doc 717","A705","2017-09-29 17:16:27"
"675","2017-09-27","888-8503375 /17-09-25","888-8503375 /17-09-25","888-8503375 /17-09-25","SEK","-3833.12","89613.44","Doc 379","A639","2017-09-29 17:16:27"
"674","2017-09-27","61383766284 /17-09-26","61383766284 /17-09-26","61383766284 /17-09-26","SEK","-509.49","93446.56","Doc 709","A680","2017-09-29 17:16:26"
"673","2017-09-27","Bg 759-8147","Bg 759-8147","Bg 759-8147","SEK","26188","93956.05","","A552,A560,A681","2017-09-29 17:16:26"
"672","2017-09-26","415-8004537 /17-09-24","415-8004537 /17-09-24","415-8004537 /17-09-24","SEK","-237.62","67768.05","Doc 377","A624","2017-09-29 17:16:26"
"671","2017-09-26","8778877815  /17-09-25","8778877815  /17-09-25","8778877815  /17-09-25","SEK","-412.46","68005.67","Doc 376","A623","2017-09-29 17:16:26"
"670","2017-09-25","Yogayama","Yogayama","Yogayama","SEK","-1250","68418.13","Doc 659","A682","2017-09-29 17:16:26"
"669","2017-09-22","Bg 759-8147","Bg 759-8147","Bg 759-8147","SEK","46875","69668.13","","A551,A561,A683","2017-09-29 17:16:26"
"668","2017-09-22","Skatteverket","Skatteverket",,"SEK","-625","22793.13","","A565","2017-09-29 17:16:26"
"667","2017-09-21","8778877815  /17-09-20","8778877815  /17-09-20","8778877815  /17-09-20","SEK","-2087.05","23418.13","Doc 652","A684","2017-09-29 17:16:26"
"666","2017-09-18","Norrsken Hou/17-09-17","Norrsken Hou/17-09-17","Norrsken Hou/17-09-17","SEK","-38750","25505.18","Doc 368","A685","2017-09-29 17:16:26"
"665","2017-09-18","Sj Mobilapp /17-09-15","Sj Mobilapp /17-09-15","Sj Mobilapp /17-09-15","SEK","-585","64255.18","Doc 366","A570","2017-09-29 17:16:26"
"664","2017-09-15","Bg 759-8147","Bg 759-8147","Bg 759-8147","SEK","688","64840.18","","A553","2017-09-29 17:16:26"
"663","2017-09-15","Yoga Shakti /silence AB","D327-P81","6018","SEK","-7700","64152.18","Doc 327","A571","2017-09-29 17:16:26"
"662","2017-09-14","8662781349  /17-09-13","8662781349  /17-09-13","8662781349  /17-09-13","SEK","-752.15","71852.18","Doc 361","A686","2017-09-29 17:16:26"
"661","2017-09-14","Bg 759-8147","Bg 759-8147","Bg 759-8147","SEK","31250","72604.33","","A554","2017-09-29 17:16:26"
"660","2017-09-13","888-8503375 /17-09-11","888-8503375 /17-09-11","888-8503375 /17-09-11","SEK","-3772.54","41354.33","Doc 362","A688","2017-09-29 17:16:26"
"659","2017-09-13","Order Moo Co/17-09-12","Order Moo Co/17-09-12","Order Moo Co/17-09-12","SEK","-671.98","45126.87","Doc 363","A576","2017-09-29 17:16:26"
"658","2017-09-13","Dooer Accounting AB","D325-P79",,"SEK","-1243.75","45798.85","Doc 325","A572","2017-09-29 17:16:26"
"657","2017-09-12","Skatteverket","R35-P90",,"SEK","-37901","47042.6","Rep 35","A689","2017-09-29 17:16:26"
"656","2017-09-11","8557983072  /17-09-09","8557983072  /17-09-09","8557983072  /17-09-09","SEK","-234.61","84943.6","Doc 359","A690","2017-09-29 17:16:25"
"655","2017-09-08","8019174292  /17-09-07","8019174292  /17-09-07","8019174292  /17-09-07","SEK","-327.35","85178.21","Doc 358","A691","2017-09-29 17:16:25"
"654","2017-09-08","Confetti Eve/17-09-07","Confetti Eve/17-09-07","Confetti Eve/17-09-07","SEK","-748.75","85505.56","Doc 357","A574","2017-09-29 17:16:25"
"653","2017-09-08","Trygg Hansa Försäkring F","Trygg Hansa Försäkring F","Trygg Hansa Försäkring F","SEK","-652","86254.31","Doc 356","A573","2017-09-29 17:16:25"
"639","2017-09-06","888-8503375 /17-09-04","888-8503375 /17-09-04","888-8503375 /17-09-04","SEK","-3756.02","86906.31","Doc 354","A541","2017-09-07 14:14:57"
"638","2017-09-06","8778877815  /17-09-05","8778877815  /17-09-05","8778877815  /17-09-05","SEK","-81.23","90662.33","Doc 675","A692","2017-09-07 14:14:57"
"637","2017-09-06","Petach Tiqwa/17-09-04","Petach Tiqwa/17-09-04","Petach Tiqwa/17-09-04","SEK","-398.04","90743.56","Doc 349","A542","2017-09-07 14:14:57"
"636","2017-09-06","Google  Goog/17-09-05","Google  Goog/17-09-05","Google  Goog/17-09-05","SEK","-19","91141.6","Doc 355","A546","2017-09-07 14:14:57"
"635","2017-09-04","8778877815  /17-09-02","8778877815  /17-09-02","8778877815  /17-09-02","SEK","-81.28","91160.6","Doc 350","A548","2017-09-07 14:14:57"
"634","2017-09-04","Hi3g","Hi3g","Hi3g","SEK","-788","91241.88","Doc 636","A693","2017-09-07 14:14:57"
"633","2017-09-04","4154486673  /17-09-02","4154486673  /17-09-02","4154486673  /17-09-02","SEK","-57.01","92029.88","Doc 351","A545","2017-09-07 14:14:57"
"632","2017-09-04","Ccögoogle Co/17-09-01","Ccögoogle Co/17-09-01","Ccögoogle Co/17-09-01","SEK","-483.34","92086.89","Doc 352","A544","2017-09-07 14:14:57"
"631","2017-09-01","Yogayama AB","D335-P92",,"SEK","-1250","92570.23","Doc 335","A537","2017-09-07 14:14:57"
"630","2017-09-01","Yogayama AB","D334-P93",,"SEK","-1250","93820.23","Doc 334","A536","2017-09-07 14:14:57"
"629","2017-08-30","888-8503375 /17-08-28","888-8503375 /17-08-28","888-8503375 /17-08-28","SEK","-3756.26","95070.23","Doc 347","A543","2017-09-07 14:14:57"
"628","2017-08-30","D346-P91","D346-P91","Representati","SEK","-430","98826.49","Doc 346","A539","2017-09-07 14:14:57"
"627","2017-08-29","Fridhemsplan/17-08-28","Fridhemsplan/17-08-28","Fridhemsplan/17-08-28","SEK","-854","99256.49","Doc 729","A694,A1076,A1135,A1136","2017-09-07 14:14:57"
"622","2017-08-28","Fridhemsplan/17-08-27","Fridhemsplan/17-08-27","Fridhemsplan/17-08-27","SEK","-854","100110.49","Doc 729","A695","2017-08-29 14:53:58"
"621","2017-08-28","Postnord Sverige AB Ao M","Postnord",,"SEK","-42","100964.49","Doc 341","A521","2017-08-29 14:53:58"
"620","2017-08-28","Trygg Hansa Försäkring F","Trygg Hansa Försäkring F","Trygg Hansa Försäkring F","SEK","-349","101006.49","Doc 342","A549","2017-08-29 14:53:58"
"619","2017-08-28","Ep Center Management AB","D343-P89","29469","SEK","-6043","101355.49","Doc 343","A524","2017-08-29 14:53:58"
"618","2017-08-28","Norrsken Hou/17-08-26","Norrsken Hou/17-08-26","Norrsken Hou/17-08-26","SEK","-11250","107398.49","Doc 345","A520","2017-08-29 14:53:58"
"617","2017-08-28","415-8004537 /17-08-24","415-8004537 /17-08-24","415-8004537 /17-08-24","SEK","-238.63","118648.49","Doc 340","A519","2017-08-29 14:53:58"
"616","2017-08-25","R34-P88","R34-P88","Lön","SEK","-7447","118887.12","Rep 34","A529","2017-08-29 14:53:58"
"615","2017-08-25","R33-P82","R33-P82","Lön","SEK","-3919","126334.12","Rep 33","A528","2017-08-29 14:53:58"
"614","2017-08-25","R33-P84","R33-P84","Lön","SEK","-11632","130253.12","Rep 33","A526","2017-08-29 14:53:58"
"613","2017-08-25","R33-P83","R33-P83","Lön","SEK","-7447","141885.12","Rep 33","A531","2017-08-29 14:53:58"
"612","2017-08-25","R33-P85","R33-P85","Lön","SEK","-20009","149332.12","Rep 33","A530","2017-08-29 14:53:58"
"611","2017-08-25","R33-P86","R33-P86","Lön","SEK","-13824","169341.12","Rep 33","A527","2017-08-29 14:53:58"
"610","2017-08-25","Yogayama","Yogayama","Yogayama","SEK","-1250","183165.12","Doc 664","A696","2017-08-29 14:53:58"
"609","2017-08-25","Firmify AB","D329-P87","114962","SEK","-12500","184415.12","Doc 329","A525","2017-08-29 14:53:58"
"608","2017-08-24","Bg 759-8147","Bg 759-8147","Bg 759-8147","SEK","5625","196915.12","","A516","2017-08-29 14:53:57"
"607","2017-08-24","Skatteverket","Skatteverket",,"SEK","-1259","191290.12","","A547","2017-08-29 14:53:57"
"606","2017-08-24","Klientmedel Billogram AB","D328-P80",,"SEK","-15310","192549.12","Doc 328","A532","2017-08-29 14:53:57"
"601","2017-08-22","Uber Bv     /17-08-21","Uber Bv     /17-08-21","Uber Bv     /17-08-21","SEK","-694.99","207859.12","Doc 332","A505","2017-08-23 18:11:28"
"600","2017-08-22","Bg 759-8147","Bg 759-8147","Bg 759-8147","SEK","21875","208554.11","","","2017-08-23 18:11:28"
"599","2017-08-21","Wellington  /17-08-21","Wellington  /17-08-21","Wellington  /17-08-21","SEK","-240.27","186679.11","Doc 337","A515","2017-08-23 18:11:28"
"598","2017-08-21","8778877815  /17-08-20","8778877815  /17-08-20","8778877815  /17-08-20","SEK","-2136.15","186919.38","Doc 651","A697","2017-08-23 18:11:28"
"597","2017-08-21","Norrsken Hou/17-08-17","Norrsken Hou/17-08-17","Norrsken Hou/17-08-17","SEK","-7500","189055.53","Doc 681","A698","2017-08-23 18:11:28"
"591","2017-08-18","Norrsken Hou/17-08-17","Norrsken Hou/17-08-17","Norrsken Hou/17-08-17","SEK","-11250","196555.53","Doc 326","A498","2017-08-20 14:32:47"
"590","2017-08-17","8778894546  /17-08-16","8778894546  /17-08-16","8778894546  /17-08-16","SEK","-83.28","207805.53","Doc 323","A494","2017-08-20 14:32:47"
"589","2017-08-16","8887999666  /17-08-15","8887999666  /17-08-15","8887999666  /17-08-15","SEK","-136.04","207888.81","Doc 324","A492","2017-08-20 14:32:47"
"588","2017-08-16","Dooer Accounting AB","D299-P73",,"SEK","-1243.75","208024.85","Doc 299","A445","2017-08-20 14:32:47"
"587","2017-08-15","Wellington  /17-08-15","Wellington  /17-08-15","Wellington  /17-08-15","SEK","-562.38","209268.6","Doc 336","A506","2017-08-20 14:32:47"
"586","2017-08-15","52223425127","52223425127","Moms Rest","SEK","-14671.4","209830.98","","A496","2017-08-20 14:32:47"
"585","2017-08-15","52223425127","52223425127","Moms 136 140","SEK","-7520","224502.38","","A495","2017-08-20 14:32:47"
"584","2017-08-15","52223425127","52223425127","Moms 133 135","SEK","-7240","232022.38","","A493","2017-08-20 14:32:47"
"583","2017-08-15","Klientmedel Billogram AB","D320-P75",,"SEK","-21875","239262.38","Doc 320","A447","2017-08-20 14:32:47"
"582","2017-08-15","Klientmedel Billogram AB","D319-P76",,"SEK","-15313","261137.38","Doc 319","A446","2017-08-20 14:32:47"
"581","2017-08-14","D289-P78","D289-P78","Arlanda Expr","SEK","-280","276450.38","Doc 289","A449","2017-08-20 14:32:47"
"580","2017-08-14","D290-P77","D290-P77","Flygbussarna","SEK","-119","276730.38","Doc 290","A448","2017-08-20 14:32:47"
"568","2017-08-14","Skatteverket","Skatteverket",,"SEK","-41529","276849.38","Rep 27","A403","2017-08-14 16:21:38"
"567","2017-08-14","52223425127","52223425127","Moms 131 130","SEK","-7340","318378.38","","","2017-08-14 16:21:38"
"566","2017-08-14","Moms 124 128","Moms 124 128","Everyday AB","SEK","-5040","325718.38","","","2017-08-14 16:21:38"
"565","2017-08-11","Bg 759-8147","Bg 759-8147","Bg 759-8147","SEK","46875","330758.38","","A385","2017-08-14 16:21:37"
"564","2017-08-10","8662781349  /17-08-09","8662781349  /17-08-09","8662781349  /17-08-09","SEK","-764.37","283883.38","Doc 313","A396","2017-08-14 16:21:37"
"563","2017-08-10","8557983072  /17-08-09","8557983072  /17-08-09","8557983072  /17-08-09","SEK","-242.58","284647.75","Doc 315","A395","2017-08-14 16:21:37"
"562","2017-08-10","Matton Butik/17-08-09","Matton Butik/17-08-09","Matton Butik/17-08-09","SEK","-295","284890.33","Doc 316","A386","2017-08-14 16:21:37"
"561","2017-08-10","Bg 759-8147","Bg 759-8147","Bg 759-8147","SEK","1500","285185.33","","A406","2017-08-14 16:21:37"
"560","2017-08-08","8019174292  /17-08-07","8019174292  /17-08-07","8019174292  /17-08-07","SEK","-382.34","283685.33","Doc 314","A398","2017-08-14 16:21:37"
"559","2017-08-08","Johan Blomborg","D258-P55","116","SEK","-13862","284067.67","Doc 258","A394","2017-08-14 16:21:37"
"558","2017-08-07","Petach Tiqwa/17-08-04","Petach Tiqwa/17-08-04","Petach Tiqwa/17-08-04","SEK","-407.21","297929.67","Doc 310","A401","2017-08-14 16:21:37"
"557","2017-08-07","Hi3g","Hi3g","Hi3g","SEK","-788","298336.88","Doc 642","A441,A747","2017-08-14 16:21:37"
"556","2017-08-07","8778877815  /17-08-05","8778877815  /17-08-05","8778877815  /17-08-05","SEK","-83.1","299124.88","Doc 674","A440,A746","2017-08-14 16:21:37"
"555","2017-08-07","Google  Goog/17-08-04","Google  Goog/17-08-04","Google  Goog/17-08-04","SEK","-19","299207.98","Doc 668","A439,A745","2017-08-14 16:21:37"
"550","2017-08-03","4154486673  /17-08-02","4154486673  /17-08-02","4154486673  /17-08-02","SEK","-57.84","299226.98","Doc 308","A351","2017-08-06 19:39:50"
"549","2017-08-03","Wellington  /17-08-03","Wellington  /17-08-03","Wellington  /17-08-03","SEK","-142.13","299284.82","Doc 338","A442","2017-08-06 19:39:50"
"548","2017-08-03","Toronto     /17-08-02","Toronto     /17-08-02","Toronto     /17-08-02","SEK","-82.47","299426.95","Doc 309","A357","2017-08-06 19:39:50"
"547","2017-08-03","Ccögoogle Co/17-08-02","Ccögoogle Co/17-08-02","Ccögoogle Co/17-08-02","SEK","-469.25","299509.42","Doc 307","A371","2017-08-06 19:39:50"
"546","2017-07-26","415-8004537 /17-07-24","415-8004537 /17-07-24","415-8004537 /17-07-24","SEK","-242.49","299978.67","Doc 305","A361","2017-08-06 19:39:50"
"545","2017-07-26","Bg 759-8147","Bg 759-8147","Bg 759-8147","SEK","31250","300221.16","","A337","2017-08-06 19:39:50"
"544","2017-07-25","R26-P72","R26-P72","Lön","SEK","-13824","268971.16","Rep 26","A354","2017-08-06 19:39:50"
"543","2017-07-25","R26-P69","R26-P69","Lön","SEK","-7447","282795.16","Rep 26","A353","2017-08-06 19:39:50"
"542","2017-07-25","R26-P71","R26-P71","Lön","SEK","-27886","290242.16","Rep 26","A352","2017-08-06 19:39:50"
"541","2017-07-25","R26-P68","R26-P68","Lön","SEK","-3919","318128.16","Rep 26","A350","2017-08-06 19:39:49"
"540","2017-07-25","Yogayama","Yogayama","Yogayama","SEK","-1250","322047.16","Doc 318","A381","2017-08-06 19:39:49"
"539","2017-07-24","Facebk  Enu5/17-07-21","Facebk  Enu5/17-07-21","Facebk  Enu5/17-07-21","SEK","-69.15","323297.16","Doc 303","A363","2017-08-06 19:39:49"
"538","2017-07-24","Facebk  Dnu5/17-07-21","Facebk  Dnu5/17-07-21","Facebk  Dnu5/17-07-21","SEK","-30.7","323366.31","Doc 304","A362","2017-08-06 19:39:49"
"537","2017-07-24","Facebk  3rah/17-07-21","Facebk  3rah/17-07-21","Facebk  3rah/17-07-21","SEK","-5.8","323397.01","Doc 302","A338","2017-08-06 19:39:49"
"536","2017-07-24","Facebk  2rah/17-07-21","Facebk  2rah/17-07-21","Facebk  2rah/17-07-21","SEK","-400","323402.81","Doc 301","A349","2017-08-06 19:39:49"
"535","2017-07-21","8778877815  /17-07-20","8778877815  /17-07-20","8778877815  /17-07-20","SEK","-2185.19","323802.81","Doc 650","A407","2017-08-06 19:39:49"
"534","2017-07-21","Klientmedel Billogram AB","D277-P67",,"SEK","-188","325988","Doc 277","A339","2017-08-06 19:39:49"
"533","2017-07-18","Bg 759-8147","Bg 759-8147","Bg 759-8147","SEK","20000","326176","","A340","2017-08-06 19:39:49"
"532","2017-07-17","D261-P63","D261-P63","5","SEK","-1800","306176","Doc 261","A341","2017-08-06 19:39:49"
"531","2017-07-14","Httpssentry /17-07-13","Httpssentry /17-07-13","Httpssentry /17-07-13","SEK","-248.43","307976","Doc 297","A365","2017-08-06 19:39:49"
"530","2017-07-14","Aws Amazon C/17-07-13","Aws Amazon C/17-07-13","Aws Amazon C/17-07-13","SEK","-7.88","308224.43","Doc 298","A364","2017-08-06 19:39:49"
"529","2017-07-13","Dooer Accounting AB","D259-P56",,"SEK","-2493.75","308232.31","Doc 259","A342","2017-08-06 19:39:49"
"528","2017-07-12","8662781349  /17-07-11","8662781349  /17-07-11","8662781349  /17-07-11","SEK","-945.68","310726.06","Doc 291","A372","2017-08-06 19:39:49"
"527","2017-07-12","Skatteverket","R25-P64",,"SEK","-40884","311671.74","Rep 25","A355","2017-08-06 19:39:49"
"526","2017-07-10","Trygg Hansa Försäkring F","Trygg Hansa Försäkring F","Trygg Hansa Försäkring F","SEK","-349","352555.74","Doc 292","A373","2017-08-06 19:39:49"
"525","2017-07-10","8019174292  /17-07-07","8019174292  /17-07-07","8019174292  /17-07-07","SEK","-329.2","352904.74","Doc 293","A366","2017-08-06 19:39:49"
"524","2017-07-07","R.a.b Event AB","D248-P62","206976","SEK","-18816","353233.94","Doc 248","A343","2017-08-06 19:39:49"
"523","2017-07-06","8778877815  /17-07-05","8778877815  /17-07-05","8778877815  /17-07-05","SEK","-86.8","372049.94","Doc 673","A410","2017-08-06 19:39:49"
"522","2017-07-06","Petach Tiqwa/17-07-04","Petach Tiqwa/17-07-04","Petach Tiqwa/17-07-04","SEK","-425.29","372136.74","Doc 287","A367","2017-08-06 19:39:49"
"521","2017-07-06","Google  Goog/17-07-05","Google  Goog/17-07-05","Google  Goog/17-07-05","SEK","-19","372562.03","Doc 667","A411,A484","2017-08-06 19:39:49"
"520","2017-07-06","Bg 759-8147","Bg 759-8147","Bg 759-8147","SEK","1500","372581.03","","A345,A480","2017-08-06 19:39:49"
"519","2017-07-05","Komplett Se /17-07-04","Komplett Se /17-07-04","Komplett Se /17-07-04","SEK","-1748.75","371081.03","Doc 288","A368","2017-08-06 19:39:49"
"518","2017-07-04","8778877815  /17-07-02","8778877815  /17-07-02","8778877815  /17-07-02","SEK","-105.82","372829.78","Doc 275","A369","2017-08-06 19:39:49"
"506","2017-07-04","Hi3g","Hi3g","Hi3g","SEK","-826","372935.6","Doc 635","A412,A482","2017-07-04 07:40:01"
"505","2017-07-04","Klientmedel Billogram AB","Hyra Kontor Klustret",,"SEK","-30500","373761.6","Doc 726","A413,A483","2017-07-04 07:40:01"
"504","2017-07-03","4154486673  /17-07-02","4154486673  /17-07-02","4154486673  /17-07-02","SEK","-60.39","404261.6","Doc 274","A336","2017-07-04 07:40:01"
"501","2017-07-03","Bg 759-8147","Bg 759-8147","Bg 759-8147","SEK","14000","404321.99","","A321","2017-07-03 11:02:48"
"500","2017-07-03","Ccögoogle Co/17-07-01","Ccögoogle Co/17-07-01","Ccögoogle Co/17-07-01","SEK","-345.98","390321.99","Doc 273","A317","2017-07-03 11:02:48"
"499","2017-07-03","8778877815  /17-06-30","8778877815  /17-06-30","8778877815  /17-06-30","SEK","-2224.17","390667.97","Doc 270","A335,A481","2017-07-03 11:02:48"
"498","2017-06-30","Klientmedel Billogram AB","D271-P65",,"SEK","-32813","392892.14","Doc 271","A309","2017-07-03 11:02:48"
"497","2017-06-30","Klientmedel Billogram AB","D272-P66",,"SEK","-14000","425705.14","Doc 272","A300,A474,A991","2017-07-03 11:02:48"
"496","2017-06-30","Roa Stockholm AB","D234-P51","11358","SEK","-25298","439705.14","Doc 234","A301","2017-07-03 11:02:48"
"495","2017-06-29","Bg 759-8147","Bg 759-8147","Bg 759-8147","SEK","39048","465003.14","","A299,A471","2017-07-03 11:02:47"
"494","2017-06-29","Klarna AB /nordea Finans","D230-P52",,"SEK","-1026.24","425955.14","Doc 230","A302,A490","2017-07-03 11:02:47"
"493","2017-06-22","Norwegian C /17-06-20","Norwegian C /17-06-20","Norwegian C /17-06-20","SEK","-494","426981.38","Doc 284","A304","2017-07-03 11:02:47"
"492","2017-06-22","Airberlin   /17-06-20","Airberlin   /17-06-20","Airberlin   /17-06-20","SEK","-2031","427475.38","Doc 285","A305,A307","2017-07-03 11:02:47"
"491","2017-06-22","R24-P59","R24-P59","Lön","SEK","-11632","429506.38","Rep 24","A313","2017-07-03 11:02:47"
"490","2017-06-22","R24-P57","R24-P57","Lön","SEK","-3919","441138.38","Rep 24","A314","2017-07-03 11:02:47"
"489","2017-06-22","R24-P61","R24-P61","Lön","SEK","-13824","445057.38","Rep 24","A316","2017-07-03 11:02:47"
"488","2017-06-22","R24-P58","R24-P58","Lön","SEK","-7447","458881.38","Rep 24","A315","2017-07-03 11:02:47"
"487","2017-06-22","R24-P60","R24-P60","Lön","SEK","-27150","466328.38","Rep 24","A312","2017-07-03 11:02:47"
"483","2017-06-16","Kostnad","Kostnad","Kostnad","SEK","-300","493478.38","","A414","2017-06-18 11:12:07"
"482","2017-06-16","271676321001","Acroyoga Solar Immersion Berlin Workshop: Per Jonsson","Acroyoga Solar Immersion Berlin Workshop: Per Jonsson","SEK","-2699.07","493778.38","Doc 260,Doc 268","A318","2017-06-18 11:12:07"
"481","2017-06-16","Dooer Accounting AB","",,"SEK","-2493","496477.45","Doc 218","A244","2017-06-18 11:12:07"
"480","2017-06-16","Klientmedel Billogram AB","D219-P49",,"SEK","-8750","498970.45","Doc 219","A241","2017-06-18 11:12:07"
"479","2017-06-13","Heroku Com  /17-06-12","Heroku Com  /17-06-12","Heroku Com  /17-06-12","SEK","-1102.43","507720.45","Doc 253","A245","2017-06-18 11:12:07"
"478","2017-06-13","Restaurang I/17-06-12","Restaurang I/17-06-12","Restaurang I/17-06-12","SEK","-655","508822.88","Doc 257","A251","2017-06-18 11:12:07"
"477","2017-06-13","Ica Kvantum /17-06-12","Ica Kvantum /17-06-12","Ica Kvantum /17-06-12","SEK","-301.96","509477.88","Doc 264","A246","2017-06-18 11:12:07"
"476","2017-06-12","Skatteverket","",,"SEK","-23801","509779.84","Rep 23","A247,A248","2017-06-18 11:12:07"
"475","2017-06-12","8557983072  /17-06-09","8557983072  /17-06-09","8557983072  /17-06-09","SEK","-258.15","533580.84","Doc 254","A249","2017-06-18 11:12:07"
"474","2017-06-09","Bg 759-8147","Bg 759-8147","Bg 759-8147","SEK","50000","533838.99","","A236","2017-06-18 11:12:07"
"473","2017-06-08","8019174292  /17-06-07","8019174292  /17-06-07","8019174292  /17-06-07","SEK","-475.36","483838.99","Doc 250","A288","2017-06-18 11:12:07"
"472","2017-06-08","Petach Tiqwa/17-06-06","Petach Tiqwa/17-06-06","Petach Tiqwa/17-06-06","SEK","-8.88","484314.35","Doc 278","A405","2017-06-18 11:12:06"
"471","2017-06-08","Petach Tiqwa/17-06-06","Petach Tiqwa/17-06-06","Petach Tiqwa/17-06-06","SEK","8.52","484323.23","Doc 778","A415,A421,A422","2017-06-18 11:12:06"
"470","2017-06-07","Grand Cayman/17-06-06","Grand Cayman/17-06-06","Grand Cayman/17-06-06","SEK","-7771.27","484314.71","Doc 246","A252","2017-06-18 11:12:06"
"469","2017-06-07","781-970-6155/17-06-06","781-970-6155/17-06-06","781-970-6155/17-06-06","SEK","-176.62","492085.98","Doc 247","A254","2017-06-18 11:12:06"
"468","2017-06-07","8778894546  /17-06-05","8778894546  /17-06-05","8778894546  /17-06-05","SEK","-91.87","492262.6","Doc 240","A378","2017-06-18 11:12:06"
"467","2017-06-07","8778894546  /17-06-05","8778894546  /17-06-05","8778894546  /17-06-05","SEK","-99.12","492354.47","Doc 240","A380,A489","2017-06-18 11:12:06"
"466","2017-06-07","8778894546  /17-06-05","8778894546  /17-06-05","8778894546  /17-06-05","SEK","-88.61","492453.59","Doc 240","A377","2017-06-18 11:12:06"
"465","2017-06-07","8778877815  /17-06-05","8778877815  /17-06-05","8778877815  /17-06-05","SEK","-88.34","492542.2","Doc 672","A416","2017-06-18 11:12:06"
"464","2017-06-07","Petach Tiqwa/17-06-04","Petach Tiqwa/17-06-04","Petach Tiqwa/17-06-04","SEK","-1316.28","492630.54","Doc 241","A253","2017-06-18 11:12:06"
"463","2017-06-07","Vimeo Plus M/17-06-05","Vimeo Plus M/17-06-05","Vimeo Plus M/17-06-05","SEK","-79.95","493946.82","Doc 283","A322","2017-06-18 11:12:06"
"462","2017-06-05","Google  Goog/17-06-04","Google  Goog/17-06-04","Google  Goog/17-06-04","SEK","-19","494026.77","Doc 242","A259","2017-06-18 11:12:06"
"461","2017-06-05","Klientmedel Billogram AB","D233-P50",,"SEK","-8750","494045.77","Doc 233","A242","2017-06-18 11:12:06"
"460","2017-06-05","3 (hi3g Access Ab)","D209-P44",,"SEK","-1111","502795.77","Doc 209","A243","2017-06-18 11:12:06"
"459","2017-06-05","4154486673  /17-06-02","4154486673  /17-06-02","4154486673  /17-06-02","SEK","-62","503906.77","Doc 236","A258","2017-06-18 11:12:06"
"458","2017-06-05","Toronto     /17-06-02","Toronto     /17-06-02","Toronto     /17-06-02","SEK","-44.2","503968.77","Doc 238","A382","2017-06-18 11:12:06"
"457","2017-06-05","G Co/payhelp/17-06-02","G Co/payhelp/17-06-02","G Co/payhelp/17-06-02","SEK","-238.36","504012.97","Doc 239","A257","2017-06-18 11:12:06"
"456","2017-06-02","Trygg Hansa Försäkring F","Trygg Hansa Försäkring F","Trygg Hansa Försäkring F","SEK","-349","504251.33","Doc 229","A264","2017-06-18 11:12:06"
"455","2017-06-02","Klientmedel Billogram AB","D222-P48",,"SEK","-12750","504600.33","Doc 222","A262","2017-06-18 11:12:06"
"454","2017-06-01","Bg 759-8147","Bg 759-8147","Bg 759-8147","SEK","33000","517350.33","","","2017-06-18 11:12:06"
"453","2017-06-01","Donati. Fel","Donati. Fel","Everyday","SEK","-600","484350.33","Doc 731","A417,A488","2017-06-18 11:12:06"
"452","2017-05-31","888-8503375 /17-05-29","888-8503375 /17-05-29","888-8503375 /17-05-29","SEK","-4121.48","484950.33","Doc 243","A266","2017-06-18 11:12:06"
"451","2017-05-30","Bg 759-8147","Bg 759-8147","Bg 759-8147","SEK","636","489071.81","","A238,A458","2017-06-18 11:12:05"
"450","2017-05-26","San Francisc/17-05-24","San Francisc/17-05-24","San Francisc/17-05-24","SEK","-0.09","488435.81","Doc 217","A269","2017-06-18 11:12:05"
"449","2017-05-26","Bg 759-8147","Bg 759-8147","Bg 759-8147","SEK","31250","488435.9","","A707,A740","2017-06-18 11:12:05"
"448","2017-05-24","888-8503375 /17-05-22","888-8503375 /17-05-22","888-8503375 /17-05-22","SEK","-1023.83","457185.9","Doc 214","A274","2017-06-18 11:12:05"
"447","2017-05-24","Holy Greens /17-05-23","Holy Greens /17-05-23","Holy Greens /17-05-23","SEK","-385","458209.73","Doc 215","A289","2017-06-18 11:12:05"
"446","2017-05-24","R18-P43","R18-P43","Lön","SEK","-13824","458594.73","Rep 18","A270","2017-06-18 11:12:05"
"445","2017-05-24","R18-P42","R18-P42","Lön","SEK","-13824","472418.73","Rep 18","A271","2017-06-18 11:12:05"
"444","2017-05-24","R18-P41","R18-P41","Lön","SEK","-11632","486242.73","Rep 18","A272","2017-06-18 11:12:05"
"443","2017-05-22","Yogayama","Yogayama","Yogayama","SEK","-1250","497874.73","Doc 317","A384","2017-06-18 11:12:05"
"442","2017-05-22","8778877815  /17-05-20","8778877815  /17-05-20","8778877815  /17-05-20","SEK","-2400.07","499124.73","Doc 649","A443,A444,A463,A990","2017-06-18 11:12:05"
"441","2017-05-19","Bg 759-8147","Bg 759-8147","Bg 759-8147","SEK","15938","501524.8","","","2017-06-18 11:12:05"
"440","2017-05-18","Tallinn     /17-05-17","Tallinn     /17-05-17","Tallinn     /17-05-17","SEK","-178.76","485586.8","Doc 211","A277","2017-06-18 11:12:05"
"439","2017-05-18","Wellington  /17-05-18","Wellington  /17-05-18","Wellington  /17-05-18","SEK","-349.06","485765.56","Doc 212","A278","2017-06-18 11:12:05"
"438","2017-05-16","Sj Mobilapp /17-05-15","Sj Mobilapp /17-05-15","Sj Mobilapp /17-05-15","SEK","-615","486114.62","Doc 207","A282","2017-06-18 11:12:05"
"437","2017-05-12","K M Epicente/17-05-11","K M Epicente/17-05-11","K M Epicente/17-05-11","SEK","-95","486729.62","Doc 201","A292","2017-06-18 11:12:05"
"436","2017-05-12","K M Epicente/17-05-11","K M Epicente/17-05-11","K M Epicente/17-05-11","SEK","-256.5","486824.62","Doc 204","A293","2017-06-18 11:12:05"
"421","2017-05-11","Dooer Accounting AB","D166-P36",,"SEK","-2493.75","487081.12","Doc 166","A210","2017-05-12 12:24:52"
"420","2017-05-10","8557983072  /17-05-09","8557983072  /17-05-09","8557983072  /17-05-09","SEK","-262.51","489574.87","Doc 200","A217","2017-05-12 12:24:52"
"419","2017-05-10","888-8503375 /17-05-08","888-8503375 /17-05-08","888-8503375 /17-05-08","SEK","-4185.56","489837.38","Doc 199","A216","2017-05-12 12:24:52"
"418","2017-05-10","8662781349  /17-05-09","8662781349  /17-05-09","8662781349  /17-05-09","SEK","-1396.49","494022.94","Doc 196","A208","2017-05-12 12:24:52"
"417","2017-05-10","K-Märkt AB","Kmärkt","Faktura 9139","SEK","-984","495419.43","Doc 155","A207,A984,A985","2017-05-12 12:24:52"
"416","2017-05-09","K M Epicente/17-05-08","K M Epicente/17-05-08","K M Epicente/17-05-08","SEK","-270","496403.43","Doc 198","A218","2017-05-12 12:24:52"
"415","2017-05-08","Trygg Hansa Försäkring F","Trygg Hansa Försäkring F","Trygg Hansa Försäkring F","SEK","-885","496673.43","Doc 208","A234,A235","2017-05-12 12:24:52"
"414","2017-05-08","3 (hi3g Access Ab)","Tre",,"SEK","-801","497558.43","Doc 183","A209","2017-05-12 12:24:52"
"413","2017-05-08","Petach Tiqwa/17-05-04","Petach Tiqwa/17-05-04","Petach Tiqwa/17-05-04","SEK","-1340.85","498359.43","Doc 678","A420,A461","2017-05-12 12:24:52"
"412","2017-05-08","8778877815  /17-05-05","8778877815  /17-05-05","8778877815  /17-05-05","SEK","-89.99","499700.28","Doc 671","A419,A462","2017-05-12 12:24:52"
"411","2017-05-08","Vimeo Plus M/17-05-05","Vimeo Plus M/17-05-05","Vimeo Plus M/17-05-05","SEK","-79.95","499790.27","Doc 281","A329","2017-05-12 12:24:52"
"410","2017-05-05","Webhallen   /17-05-04","Webhallen   /17-05-04","Webhallen   /17-05-04","SEK","-2990","499870.22","Doc 195","A215","2017-05-12 12:24:52"
"409","2017-05-05","8778877815  /17-05-02","8778877815  /17-05-02","8778877815  /17-05-02","SEK","-44.93","502860.22","Doc 189","A213","2017-05-12 12:24:52"
"408","2017-05-03","4154486673  /17-05-02","4154486673  /17-05-02","4154486673  /17-05-02","SEK","-63.04","502905.15","Doc 186","A214","2017-05-12 12:24:52"
"407","2017-05-03","G Co/payhelp/17-05-02","G Co/payhelp/17-05-02","G Co/payhelp/17-05-02","SEK","-285.66","502968.19","Doc 187","A212","2017-05-12 12:24:52"
"406","2017-05-02","Wellington  /17-05-02","Wellington  /17-05-02","Wellington  /17-05-02","SEK","-351.4","503253.85","Doc 339","A418,A460","2017-05-12 12:24:52"
"405","2017-05-02","9172677480 /17-04-28",,,"SEK","-171.35","503605.25","Doc 184","A201","2017-05-02 16:32:50"
"404","2017-04-27","C off ideell förening","D138-p33","202","SEK","-1200","503776.6","Doc 138","A202","2017-05-02 16:32:50"
"403","2017-04-26","Klientmedel billogram AB","D140-p32",,"SEK","-4338","507075.5","Doc 140","A204","2017-05-02 16:32:50"
"402","2017-04-26","Ha0453777226",,,"SEK","-797","506278.5","Doc 182","A203","2017-05-02 16:32:50"
"401","2017-04-26","SJ MOBILAPP /17-04-25",,,"SEK","-296","505982.5","Doc 210","A222","2017-05-02 16:32:49"
"400","2017-04-26","STENUGNSBAGE /17-04-25",,,"SEK","-120","505862.5","Doc 180","A211","2017-05-02 16:32:49"
"399","2017-04-26","8778894546 /17-04-25",,,"SEK","-91.88","505770.62","Doc 177","A200","2017-05-02 16:32:49"
"398","2017-04-26","888-8503375 /17-04-24",,,"SEK","-270.51","505500.11","Doc 179","A197","2017-05-02 16:32:49"
"397","2017-04-26","SAN FRANCISC /17-04-24",,,"SEK","-523.51","504976.6","Doc 178","A199","2017-05-02 16:32:49"
"395","2017-04-25","R9-p39",,,"SEK","-13824","536869.5","Rep 9","A219,A220,A221","2017-04-25 17:04:39"
"394","2017-04-25","R9-p38",,,"SEK","-13824","523045.5","Rep 9","A219,A220,A221","2017-04-25 17:04:39"
"393","2017-04-25","R9-p37",,,"SEK","-11632","511413.5","Rep 9","A219,A220,A221","2017-04-25 17:04:39"
"392","2017-04-24","SYSTEMBOLAGE /17-04-21",,,"SEK","-247.5","551122.18","Doc 648","A225","2017-04-25 17:04:39"
"391","2017-04-24","PETACH TIQWA /17-04-20",,,"SEK","-428.68","550693.5","Doc 174","A143","2017-04-25 17:04:39"
"390","2017-04-21","8778877815 /17-04-20",,,"SEK","-2465.42","551369.68","Doc 657","A226","2017-04-25 17:04:39"
"389","2017-04-20","Klientmedel billogram AB","Klustret",,"SEK","-14625","569085.1","Doc 726","A228","2017-04-25 17:04:39"
"388","2017-04-20","Klientmedel billogram AB","Klustret",,"SEK","-15250","553835.1","Doc 725","A229","2017-04-25 17:04:39"
"387","2017-04-19","Stf ekskäret",,,"SEK","500000","569945.47","Rep 19","A230","2017-04-25 17:04:39"
"386","2017-04-19","Bg 759-8147",,,"SEK","14000","583945.47","Doc 525","A231","2017-04-25 17:04:39"
"385","2017-04-19","888-8503375 /17-04-17",,,"SEK","-235.37","583710.1","Doc 170","A138","2017-04-25 17:04:39"
"384","2017-04-18","447983013899 /17-04-11",,,"SEK","-1464.77","70729.21","Doc 168","A142","2017-04-25 17:04:39"
"383","2017-04-18","KOMPLETT SE /17-04-17",,,"SEK","-549","70180.21","Doc 171","A144","2017-04-25 17:04:39"
"382","2017-04-18","TALLINN /17-04-17",,,"SEK","-234.74","69945.47","Doc 169","A168","2017-04-25 17:04:39"
"381","2017-04-12","Skatteverket","R8-p34",,"SEK","-25467","79013.4","Doc 157","A147","2017-04-25 17:04:38"
"380","2017-04-12","8662781349 /17-04-11",,,"SEK","-1305.36","77708.04","Doc 161","A140","2017-04-25 17:04:38"
"379","2017-04-12","888-8503375 /17-04-10",,,"SEK","-5514.06","72193.98","Doc 165","A139","2017-04-25 17:04:38"
"378","2017-04-10","8019174292 /17-04-07",,,"SEK","-165.53","104748.42","Doc 163","A146","2017-04-25 17:04:38"
"377","2017-04-10","8557983072 /17-04-09",,,"SEK","-268.02","104480.4","Doc 164","A167","2017-04-25 17:04:38"
"376","2017-04-07","Klientmedel billogram AB","Billogram",,"SEK","-208","108570.2","Doc 156","A164","2017-04-25 17:04:38"
"375","2017-04-07","D136-p31",,,"SEK","-3656.25","104913.95","Doc 136","A148,A196","2017-04-25 17:04:38"
"374","2017-04-06","VIMEO COM /17-04-05",,,"SEK","-79.95","109227.27","Doc 282","A227","2017-04-25 17:04:38"
"373","2017-04-06","PETACH TIQWA /17-04-04",,,"SEK","-449.07","108778.2","Doc 154","A145","2017-04-25 17:04:38"
"372","2017-04-05","SEMPRE ESPRE /17-04-04",,,"SEK","-80","119064.12","Doc 153","A198","2017-04-25 17:04:38"
"371","2017-04-05","888-8503375 /17-04-03",,,"SEK","-9756.9","109307.22","Doc 152","A141","2017-04-25 17:04:38"
"370","2017-04-04","8778877815 /17-04-02",,,"SEK","-45.56","119144.12","Doc 150","A165","2017-04-25 17:04:38"
"369","2017-04-03","NETONNET AB /17-03-28",,,"SEK","-14990","119567.42","Doc 145","A150","2017-04-25 17:04:38"
"368","2017-04-03","G CO/PAYHELP /17-04-02",,,"SEK","-313.81","119253.61","Doc 151","A149","2017-04-25 17:04:38"
"367","2017-04-03","4154486673 /17-04-02",,,"SEK","-63.93","119189.68","Doc 149","A166","2017-04-25 17:04:38"
"366","2017-03-31","9172677480 /17-03-28",,,"SEK","-170.73","141782.17","Doc 143","A136","2017-04-25 17:04:38"
"365","2017-03-31","888-8503375 /17-03-27",,,"SEK","-7224.75","134557.42","Doc 139","A135,A178","2017-04-25 17:04:38"
"364","2017-03-30","Klientmedel billogram AB","D99-p19",,"SEK","-3750","141952.9","Doc 99","A137","2017-04-25 17:04:38"
"360","2017-03-27","SAN FRANCISC /17-03-24",,,"SEK","-521.78","129764.9","Doc 716","A169","2017-03-27 20:59:37"
"359","2017-03-27","Bg 759-8147",,,"SEK","15938","145702.9","Doc 117","A103","2017-03-27 20:59:37"
"358","2017-03-24","Klientmedel billogram AB","D114-p22",,"SEK","-12500","221815.58","Doc 114","A72,A195","2017-03-27 20:59:37"
"357","2017-03-24","Klientmedel billogram AB","D118-p21",,"SEK","-55250","166565.58","Doc 118","A113","2017-03-27 20:59:37"
"356","2017-03-24","R7-p27",,,"SEK","-13824","152741.58","Rep 7","A123,A124,A125,A126","2017-03-27 20:59:37"
"355","2017-03-24","R7-p24",,,"SEK","-11632","141109.58","Rep 7","A123,A124,A125,A126","2017-03-27 20:59:37"
"354","2017-03-24","R7-p26",,,"SEK","-13824","127285.58","Rep 7","A123,A124,A125,A126","2017-03-27 20:59:37"
"353","2017-03-24","D128-p29",,,"SEK","-3500","123785.58","Doc 128","A115","2017-03-27 20:59:37"
"352","2017-03-24","R7-p25",,,"SEK","-3919","119866.58","Rep 7","A123,A124,A125,A126","2017-03-27 20:59:37"
"351","2017-03-24","D127-p28",,,"SEK","-3500","116366.58","Doc 127","A114","2017-03-27 20:59:37"
"350","2017-03-24","Bg 759-8147",,,"SEK","14000","130366.58","Doc 158","A133","2017-03-27 20:59:37"
"349","2017-03-24","KJELL & CO 2 /17-03-23",,,"SEK","-79.9","130286.68","Doc 133","A105","2017-03-27 20:59:37"
"348","2017-03-23","H23359981640",,"DIS                                VORES KONTONR.                     FAKTURA 132","SEK","4000","234315.58","Doc 190","A179","2017-03-27 20:59:37"
"347","2017-03-22","ORANGE COUNT /17-03-21",,,"SEK","-80","228919.63","Doc 132","A116","2017-03-27 20:59:37"
"346","2017-03-22","888-8503375 /17-03-20",,,"SEK","1395.95","230315.58","Doc 768","A180","2017-03-27 20:59:36"
"345","2017-03-21","8778877815 /17-03-20",,,"SEK","-2333.28","228999.63","Doc 141","A106","2017-03-27 20:59:36"
"344","2017-03-20","447983013899 /17-03-15",,,"SEK","-6038.75","235314.79","Doc 124","A112","2017-03-27 20:59:36"
"343","2017-03-20","TALLINN /17-03-17",,,"SEK","-231.88","235082.91","Doc 129","A107","2017-03-27 20:59:36"
"342","2017-03-20","Klientmedel billogram AB","D79-p13",,"SEK","-3750","231332.91","Doc 79","A76","2017-03-27 20:59:36"
"341","2017-03-16","3 (hi3g access AB)","Tre",,"SEK","-854","207603.54","Doc 92","A74","2017-03-27 20:59:36"
"340","2017-03-16","Bg 759-8147",,,"SEK","33750","241353.54","Doc 86","A104","2017-03-27 20:59:36"
"339","2017-03-15","8662781349 /17-03-14",,,"SEK","-1103.39","208965.61","Doc 105","A109","2017-03-27 20:59:36"
"338","2017-03-15","888-8503375 /17-03-13",,,"SEK","-508.07","208457.54","Doc 122","A108","2017-03-27 20:59:36"
"337","2017-03-14","SEMPRE ESPRE /17-03-13",,,"SEK","-80","210069","Doc 121","A127","2017-03-27 20:59:36"
"336","2017-03-13","Skatteverket","D107-p20",,"SEK","-80647","211638.17","Doc 107","A111","2017-03-27 20:59:36"
"335","2017-03-13","888-8503375 /17-03-10",,,"SEK","-1489.17","210149","Doc 119","A110","2017-03-27 20:59:36"
"334","2017-03-10","SEB kort",,,"SEK","-290.97","292995.93","Doc 728","A181","2017-03-27 20:59:36"
"333","2017-03-10","8019174292 /17-03-09",,,"SEK","-443.42","292552.51","Doc 116","A118","2017-03-27 20:59:36"
"332","2017-03-10","8557983072 /17-03-09",,,"SEK","-267.34","292285.17","Doc 115","A117","2017-03-27 20:59:36"
"331","2017-03-08","Pollux inves",,,"SEK","5","293237.9","","A163","2017-03-27 20:59:36"
"330","2017-03-08","Selecta",,,"SEK","22","293259.9","","A162","2017-03-27 20:59:36"
"329","2017-03-08","Selecta",,,"SEK","27","293286.9","","A161","2017-03-27 20:59:36"
"325","2017-03-06","Överbe skatt",,,"SEK","-2716","297273.98","Doc 612","A188","2017-03-27 20:59:36"
"328","2017-03-06","WEBHALLEN /17-03-03",,,"SEK","-3790","293483.98","Doc 120","A119","2017-03-27 20:59:36"
"327","2017-03-06","8778877815 /17-03-02",,,"SEK","-64.04","293419.94","Doc 110","A122","2017-03-27 20:59:36"
"326","2017-03-06","8778894546 /17-03-03",,,"SEK","-187.04","293232.9","Doc 106","A120","2017-03-27 20:59:36"
"324","2017-03-03","Bg 759-8147",,,"SEK","250.41","300442.9","Doc 45","A160,A206","2017-03-27 20:59:36"
"323","2017-03-03","CCÖGOOGLE CO /17-03-02",,,"SEK","-388.22","300054.68","Doc 111","A68","2017-03-27 20:59:36"
"322","2017-03-03","4154486673 /17-03-02",,,"SEK","-64.7","299989.98","Doc 108","A121","2017-03-27 20:59:36"
"321","2017-03-02","Klientmedel billogram AB","Ekskäret gemenskap",,"SEK","-14625","383188.49","Doc 28","A101,A102","2017-03-27 20:59:35"
"320","2017-03-02","Aktieutdeln",,,"SEK","-82996","300192.49","Rep 10","A176,A177","2017-03-27 20:59:35"
"319","2017-02-27","8778877815 /17-02-24",,,"SEK","-2332.69","395596.47","Doc 100","A66","2017-03-27 20:59:35"
"318","2017-02-27","SAN FRANCISC /17-02-24",,,"SEK","-532.98","395063.49","Doc 95","A69","2017-03-27 20:59:35"
"317","2017-02-27","Yogayama AB","D81-p12",,"SEK","-1250","393813.49","Doc 81","A73,A223,A224","2017-03-27 20:59:35"
"316","2017-02-27","Bg 759-8147",,,"SEK","4000","397813.49","Doc 160","A134,A158,A159","2017-03-27 20:59:35"
"315","2017-02-24","Skatteverket","R4-p10",,"SEK","-25467","486907.38","Doc 62","A79","2017-03-27 20:59:35"
"314","2017-02-24","R5-p17",,,"SEK","-13824","473083.38","Rep 5","A83,A84,A85,A86","2017-03-27 20:59:35"
"313","2017-02-24","R5-p15",,,"SEK","-3919","469164.38","Rep 5","A83,A84,A85,A86","2017-03-27 20:59:35"
"312","2017-02-24","R5-p16",,,"SEK","-50638","418526.38","Rep 5","A83,A84,A85,A86","2017-03-27 20:59:35"
"311","2017-02-24","R5-p14",,,"SEK","-11632","406894.38","Rep 5","A83,A84,A85,A86","2017-03-27 20:59:35"
"310","2017-02-24","ELGIGANTEN S /17-02-23",,,"SEK","-8289","398605.38","Doc 91","A71","2017-03-27 20:59:35"
"309","2017-02-24","PARADISET CI /17-02-23",,,"SEK","-147","398458.38","Doc 87","A70","2017-03-27 20:59:35"
"308","2017-02-24","8778877815 /17-02-23",,,"SEK","-529.22","397929.16","Doc 96","A67","2017-03-27 20:59:35"
"307","2017-02-23","TALLINN /17-02-22",,,"SEK","-231.53","512374.38","Doc 85","A78","2017-03-27 20:59:35"
"306","2017-02-20","Från moms",,,"SEK","28533","512605.91","","","2017-03-27 20:59:35"
"305","2017-02-17","Skatteverket","Moms skatteverket",,"SEK","-131767","484421.91","Doc 80","A80,A81,A82","2017-03-27 20:59:35"
"304","2017-02-17","SELECTA /17-02-16",,,"SEK","-27","484394.91","","A155","2017-03-27 20:59:35"
"303","2017-02-17","SELECTA /17-02-16",,,"SEK","-22","484372.91","","A156","2017-03-27 20:59:35"
"302","2017-02-17","POLLUX INVES /17-02-16",,,"SEK","-5","484367.91","","A157","2017-03-27 20:59:35"
"301","2017-02-17","THELINS KOND /17-02-16",,,"SEK","-295","484072.91","Doc 78","A75","2017-03-27 20:59:35"
"300","2017-02-16","Moms",,,"SEK","131767","618678.91","","A154,A174","2017-03-27 20:59:35"
"299","2017-02-16","WEBHALLEN /17-02-15",,,"SEK","-2490","616188.91","Doc 63","A64","2017-03-27 20:59:35"
"298","2017-02-15","Me&do AB","","Faktura 149","SEK","-25000","486911.91","Doc 61","A129,A194","2017-03-27 20:59:35"
"297","2017-02-14","8662781349 /17-02-13",,,"SEK","-1081.35","511911.91","Doc 52","A131","2017-03-27 20:59:34"
"296","2017-02-13","DB TT/CCHELP /17-02-11",,,"SEK","-90.75","512993.26","Doc 191","A153,A205,A982","2017-03-27 20:59:34"
"295","2017-02-10","SEMPRE ESPRE /17-02-09",,,"SEK","-64","513649.77","Doc 54","A63","2017-03-27 20:59:34"
"294","2017-02-10","8019174292 /17-02-09",,,"SEK","-302.95","513346.82","Doc 53","A77","2017-03-27 20:59:34"
"293","2017-02-10","8557983072 /17-02-09",,,"SEK","-262.81","513084.01","Doc 65","A128","2017-03-27 20:59:34"
"292","2017-02-09","Banktjänster",,,"SEK","-32.5","516163.77","Doc 55","A61","2017-03-27 20:59:34"
"291","2017-02-09","Banktjänster",,,"SEK","-2450","513713.77","Doc 56","A62","2017-03-27 20:59:34"
"290","2017-02-07","YOGAYAMA AB /17-02-06",,,"SEK","-1027","516196.66","Doc 51","A60","2017-03-27 20:59:34"
"289","2017-02-07","WELLINGTON /17-02-07",,,"SEK","8.61","516205.27","","A152","2017-03-27 20:59:34"
"288","2017-02-07","WELLINGTON /17-02-07",,,"SEK","-9","516196.27","","A151","2017-03-27 20:59:34"
"171","2017-02-06","3 (hi3g access AB)","Tre mobilfaktura",,"SEK","-821","520156.35","Doc 30","A13","2017-02-06 13:27:04"
"170","2017-02-06","SEB kort",,,"SEK","-2932.69","517223.66","Doc 76","A41","2017-02-06 13:27:04"
"169","2017-02-03","CCÖGOOGLE CO /17-02-02",,,"SEK","-373.47","521061.85","Doc 48","A3","2017-02-06 13:27:04"
"168","2017-02-03","4154486673 /17-02-02",,,"SEK","-62.33","520999.52","Doc 47","A4","2017-02-06 13:27:04"
"167","2017-02-03","8778877815 /17-02-02",,,"SEK","-22.17","520977.35","Doc 50","A2","2017-02-06 13:27:04"
"166","2017-02-02","FACEBK  MJQZ /17-02-01",,,"SEK","-425.25","521435.32","Doc 42","A6","2017-02-06 13:27:04"
"165","2017-01-31","Lön per korr",,,"SEK","-19798","478860.57","Rep 14","A182","2017-02-06 13:27:04"
"164","2017-01-31","Moms skl",,,"SEK","-10750","468110.57","","A183","2017-02-06 13:27:04"
"163","2017-01-31","Bg 759-8147",,,"SEK","53750","521860.57","Doc 77","A59","2017-02-06 13:27:04"
"162","2017-01-25","Dooer r2-p7",,,"SEK","-13824","528114.22","Rep 2","A58","2017-02-06 13:27:04"
"161","2017-01-25","Dooer r2-p6",,,"SEK","-13824","514290.22","Rep 2","A58","2017-02-06 13:27:04"
"160","2017-01-25","Dooer r2-p5",,,"SEK","-3919","510371.22","Rep 2","A58","2017-02-06 13:27:04"
"159","2017-01-25","Dooer r2-p4",,,"SEK","-11632","498739.22","Rep 2","A58","2017-02-06 13:27:04"
"158","2017-01-25","3233752822 /17-01-24",,,"SEK","-80.65","498658.57","Doc 41","A7","2017-02-06 13:27:04"
"157","2017-01-24","8778877815 /17-01-23",,,"SEK","-387.53","541938.22","Doc 40","A8","2017-02-06 13:27:04"
"156","2017-01-23","8778877815 /17-01-20",,,"SEK","-1291.17","542325.75","Doc 101","A65,A172,A173","2017-02-06 13:27:04"
"155","2017-01-20","Klientmedel billogram AB","Ekskäret gemenskap",,"SEK","-14625","543616.92","Doc 28","A101,A102","2017-02-06 13:27:04"
"154","2017-01-19","270195501708",,"Invoice 0000572","SEK","-1988","558243.92","Doc 38","A11,A100","2017-02-06 13:27:04"
"153","2017-01-19","Kostnad",,,"SEK","-2","558241.92","Doc 38","A100","2017-02-06 13:27:03"
"147","2017-01-18","Account factory sweden a","Faktura 13381","Faktura 13381","SEK","-6250","560518.92","Doc 27","A14,A98,A171,A464,A465","2017-01-18 17:01:58"
"151","2017-01-18","LOOPIA AB /17-01-17",,,"SEK","-287","560231.92","Doc 26","A15","2017-01-18 21:45:39"
"146","2017-01-17","Skatteverket","Skatteverket",,"SEK","-34440","566768.92","Doc 20","A97","2017-01-18 17:01:58"
"145","2017-01-16","Bg 759-8147",,,"SEK","314000","713708.92","Doc 29,Doc 46","A29,A30","2017-01-18 17:01:58"
"144","2017-01-16","Moms skl",,,"SEK","-62500","651208.92","","A93","2017-01-18 17:01:58"
"143","2017-01-16","Moms rest",,,"SEK","-50000","601208.92","","A95","2017-01-18 17:01:58"
"142","2017-01-13","Firmify AB","Faktura 111962","Faktura 111962","SEK","-7500","405828.34","Doc 23","A28,A99","2017-01-18 17:01:58"
"141","2017-01-13","Moms fak 123",,,"SEK","-300","405528.34","","A87","2017-01-18 17:01:58"
"140","2017-01-13","Moms fak 115",,,"SEK","-700","404828.34","","A89","2017-01-18 17:01:58"
"139","2017-01-13","Moms fak 112",,,"SEK","-3750","401078.34","","A91","2017-01-18 17:01:58"
"138","2017-01-13","GRODAN GREV /17-01-12",,,"SEK","-440","400638.34","Doc 24","A16","2017-01-18 17:01:58"
"137","2017-01-13","8662781349 /17-01-12",,,"SEK","-929.42","399708.92","Doc 39","A9","2017-01-18 17:01:58"
"131","2017-01-11","K M EPICENTE /17-01-10",,,"SEK","-58","413328.34","Doc 22","A17","2017-01-11 20:23:53"
"130","2017-01-09","SEB kort",,,"SEK","-11300.44","413386.34","Doc 10","A31,A190,A191","2017-01-11 20:23:53"
"110","2017-01-03","3 (hi3g access AB)","Tre mobilfaktura",,"SEK","-798","424686.78","Doc 17","A24","2017-01-03 12:30:32"